puckman	PuckMan (Japan set 1)
puckmana	PuckMan (Japan set 2)
pacman	Pac-Man (Midway)
puckmod	PuckMan (harder?)
pacmod	Pac-Man (Midway, harder)
hangly	Hangly-Man (set 1)
hangly2	Hangly-Man (set 2)
hangly3	Hangly-Man (set 3)
newpuckx	New Puck-X
pacheart	Pac-Man (Hearts)
joyman	Joyman
newpuc2	Newpuc2
newpuc2b	Newpuc2 (set 2)
piranha	Piranha
piranhao	Piranha (older)
piranhah	Piranha (hack)
nmouse	Naughty Mouse (set 1)
nmouseb	Naughty Mouse (set 2)
pacplus	Pac-Man Plus
mspacman	Ms. Pac-Man
mspacmab	Ms. Pac-Man (bootleg)
mspacmat	Ms. Pac Attack
mspacpls	Ms. Pac-Man Plus
pacgal	Pac-Gal
mschamp	Ms. Pacman Champion Edition / Super Zola Pac Gal
maketrax	Make Trax (set 1)
maketrxb	Make Trax (set 2)
korosuke	Korosuke Roller
crush	Crush Roller (Kural Samno)
crush2	Crush Roller (Kural Esco - bootleg?)
crush3	Crush Roller (Kural - bootleg?)
mbrush	Magic Brush
paintrlr	Paint Roller
eyes	Eyes (Digitrex Techstar)
eyes2	Eyes (Techstar)
mrtnt	Mr. TNT
gorkans	Gorkans
eggor	Eggor
ponpoko	Ponpoko
ponpokov	Ponpoko (Venture Line)
lizwiz	Lizard Wizard
theglobp	The Glob (Pac-Man hardware)
beastf	Beastie Feastie
acitya	Atlantic City Action
bwcasino	Boardwalk Casino
dremshpr	Dream Shopper
vanvan	Van-Van Car
vanvank	Van-Van Car (Karateco)
alibaba	Ali Baba and 40 Thieves
pengo	Pengo (set 1 rev c)
pengo2	Pengo (set 2)
pengo2u	Pengo (set 2 not encrypted)
pengo3u	Pengo (set 3 not encrypted)
pengob	Pengo (bootleg)
penta	Penta
jrpacman	Jr. Pac-Man
jumpshot	Jump Shot
shootbul	Shoot the Bull
bigbucks	Big Bucks
drivfrcp	Driving Force (Pac-Man conversion)
8bpm	Eight Ball Action (Pac-Man conversion)
porky	Porky
megadon	Megadon
catapult	Catapult
suprglob	Super Glob
theglob	The Glob
theglob2	The Glob (earlier)
theglob3	The Glob (set 3)
igmo	IGMO
dealer	The Dealer
galaxian	Galaxian (Namco set 1)
galaxiaj	Galaxian (Namco set 2)
galmidw	Galaxian (Midway)
galmidwo	Galaxian (Midway, old rev)
superg	Super Galaxians
galapx	Galaxian Part X
moonaln	Moon Alien
galap1	Space Invaders Galactica
galap4	Galaxian Part 4
galturbo	Galaxian Turbo
swarm	Swarm
zerotime	Zero Time
tst_galx	Galaxian Test ROM
gmgalax	Ghostmuncher Galaxian (bootleg)
pisces	Pisces
piscesb	Pisces (bootleg)
uniwars	UniWar S
gteikoku	Gingateikoku No Gyakushu
gteikokb	Gingateikoku No Gyakushu (bootleg set 1)
gteikob2	Gingateikoku No Gyakushu (bootleg set 2)
spacbatt	Space Battle
skyraidr	Sky Raiders
batman2	Batman Part 2
warofbug	War of the Bugs or Monsterous Manouvers in a Mushroom Maze
redufo	Defend the Terra Attack on the Red UFO
exodus	Exodus (bootleg?)
streakng	Streaking
pacmanbl	Pac-Man (Galaxian hardware)
devilfsg	Devil Fish (Galaxian hardware, bootleg?)
zigzag	Zig Zag (Galaxian hardware, set 1)
zigzag2	Zig Zag (Galaxian hardware, set 2)
jumpbug	Jump Bug
jumpbugb	Jump Bug (bootleg)
levers	Levers
azurian	Azurian Attack
orbitron	Orbitron
mooncrgx	Moon Cresta (Galaxian hardware)
mooncrst	Moon Cresta (Nichibutsu)
mooncrsu	Moon Cresta (Nichibutsu, unencrypted)
mooncrsa	Moon Cresta (Nichibutsu, old rev)
mooncrsg	Moon Cresta (Gremlin)
smooncrs	Super Moon Cresta
mooncrsb	Moon Cresta (bootleg set 1)
mooncrs2	Moon Cresta (bootleg set 2)
fantazia	Fantazia
moonqsr	Moon Quasar
mshuttle	Moon Shuttle (US?)
mshuttlj	Moon Shuttle (Japan)
moonal2	Moon Alien Part 2
moonal2b	Moon Alien Part 2 (older version)
eagle	Eagle (set 1)
eagle2	Eagle (set 2)
skybase	Sky Base
checkman	Check Man
checkmaj	Check Man (Japan)
dingo	Dingo
blkhole	Black Hole
kingball	King & Balloon (US)
kingbalj	King & Balloon (Japan)
scorpnmc	Scorpion (Moon Cresta hardware)
frogg	Frog (Galaxian hardware)
4in1	4 Fun in 1
bagmanmc	Bagman (Moon Cresta hardware)
dkongjrm	Donkey Kong Jr. (Moon Cresta hardware)
ozon1	Ozon I
ladybugg	Ladybug (bootleg on Galaxian hardware)
vpool	Video Pool (bootleg on Moon Cresta hardware)
drivfrcg	Driving Force (Galaxian conversion)
rockclim	Rock Climber
scramble	Scramble
scrambls	Scramble (Stern)
scramblb	Scramble (Galaxian hardware)
explorer	Explorer
atlantis	Battle of Atlantis (set 1)
atlants2	Battle of Atlantis (set 2)
theend	The End
theends	The End (Stern)
omega	Omega
ckongs	Crazy Kong (Scramble hardware)
froggers	Frog
amidars	Amidar (Scramble hardware)
triplep	Triple Punch
knockout	Knock Out!!
mariner	Mariner
800fath	800 Fathoms
mars	Mars
devilfsh	Devil Fish
newsin7	New Sinbad 7
mrkougar	Mr. Kougar
mrkougr2	Mr. Kougar (earlier)
mrkougb	Mr. Kougar (bootleg)
hotshock	Hot Shocker
hunchbks	Hunchback (Scramble hardware)
cavelon	Cavelon
sfx	SF-X
mimonscr	Mighty Monkey (bootleg on Scramble hardware)
mimonkey	Mighty Monkey
mimonsco	Mighty Monkey (bootleg on Super Cobra hardware)
scobra	Super Cobra
scobras	Super Cobra (Stern)
scobrase	Super Cobra (Sega)
scobrab	Super Cobra (bootleg)
stratgyx	Strategy X
stratgys	Strategy X (Stern)
armorcar	Armored Car (set 1)
armorca2	Armored Car (set 2)
moonwar	Moonwar
moonwara	Moonwar (older)
spdcoin	Speed Coin (prototype)
darkplnt	Dark Planet
tazmania	Tazz-Mania (set 1)
tazmani2	Tazz-Mania (set 2)
calipso	Calipso
anteater	Anteater
rescue	Rescue
aponow	Apocaljpse Now
minefld	Minefield
losttomb	Lost Tomb (easy)
losttmbh	Lost Tomb (hard)
superbon	Super Bond
hustler	Video Hustler
billiard	The Billiards
hustlerb	Video Hustler (bootleg)
frogger	Frogger
frogseg1	Frogger (Sega set 1)
frogseg2	Frogger (Sega set 2)
froggrmc	Frogger (Moon Cresta hardware)
amidar	Amidar
amidaru	Amidar (Stern)
amidaro	Amidar (Olympia)
amigo	Amigo
turtles	Turtles
turpin	Turpin
600	600
flyboy	Fly-Boy
flyboyb	Fly-Boy (bootleg)
fastfred	Fast Freddie
jumpcoas	Jump Coaster
boggy84	Boggy '84
redrobin	Red Robin
imago	Imago
cclimber	Crazy Climber (US)
cclimbrj	Crazy Climber (Japan)
ccboot	Crazy Climber (bootleg set 1)
ccboot2	Crazy Climber (bootleg set 2)
ckong	Crazy Kong (set 1)
ckonga	Crazy Kong (set 2)
ckongjeu	Crazy Kong (Jeutel bootleg)
ckongo	Crazy Kong (Orca bootleg)
ckongalc	Crazy Kong (Alca bootleg)
monkeyd	Monkey Donkey
rpatrolb	River Patrol (bootleg)
silvland	Silver Land
yamato	Yamato (US)
yamato2	Yamato (World?)
swimmer	Swimmer (set 1)
swimmera	Swimmer (set 2)
swimmerb	Swimmer (set 3)
guzzler	Guzzler
cannonb	Cannon Ball (Crazy Climber hardware)
gomoku	Gomoku Narabe Renju
wiping	Wiping
rugrats	Rug Rats
friskyt	Frisky Tom (set 1)
friskyta	Frisky Tom (set 2)
radrad	Radical Radial
seicross	Seicross
sectrzon	Sector Zone
firebatl	Fire Battle
clshroad	Clash-Road
tubep	Tube Panic
rjammer	Roller Jammer
magmax	Mag Max
cop01	Cop 01 (set 1)
cop01a	Cop 01 (set 2)
mightguy	Mighty Guy
terracre	Terra Cresta (YM3526 set 1)
terracrb	Terra Cresta (YM3526 set 2)
terracra	Terra Cresta (YM2203)
amazon	Soldier Girl Amazon
amatelas	Sei Senshi Amatelass
horekid	Kid no Hore Hore Daisakusen
horekidb	Kid no Hore Hore Daisakusen (bootleg)
galivan	Galivan - Cosmo Police (12/16/1985)
galivan2	Galivan - Cosmo Police (12/11/1985)
dangar	Dangar - Ufo Robo (12/1/1986)
dangar2	Dangar - Ufo Robo (9/26/1986)
dangarb	Dangar - Ufo Robo (bootleg)
ninjemak	Ninja Emaki (US)
youma	Youma Ninpou Chou (Japan)
legion	Legion (ver 2.03)
legiono	Legion (ver 1.05)
terraf	Terra Force
terrafu	Terra Force (US)
kodure	Kodure Ookami (Japan)
armedf	Armed Formation
cclimbr2	Crazy Climber 2 (Japan)
hyhoo	Taisen Quiz HYHOO (Japan)
hyhoo2	Taisen Quiz HYHOO 2 (Japan)
pastelgl	Pastel Gal (Japan 851224)
crystalg	Crystal Gal (Japan 860512)
crystal2	Crystal Gal 2 (Japan 860620)
citylove	City Love (Japan 860908)
apparel	Apparel Night (Japan 860929)
secolove	Second Love (Japan 861201)
housemnq	House Mannequin (Japan 870217)
housemn2	House Mannequin Roppongi Live hen (Japan 870418)
seiha	Seiha (Japan 870725)
seiham	Seiha [BET] (Japan 870723)
bijokkoy	Bijokko Yume Monogatari (Japan 870925)
iemoto	Iemoto (Japan 871020)
ojousan	Ojousan (Japan 871204)
bijokkog	Bijokko Gakuen (Japan 880116)
orangec	Orange Club - Maruhi Kagai Jugyou (Japan 880213)
vipclub	Vip Club [BET] (Japan 880310)
korinai	Mahjong-zukino Korinai Menmen (Japan 880425)
kaguya	Mahjong Kaguyahime [BET] (Japan 880521)
otonano	Otona no Mahjong (Japan 880628)
kanatuen	Kanatsuen no Onna [BET] (Japan 880905)
mjsikaku	Mahjong Shikaku (Japan 880908)
mjsikakb	Mahjong Shikaku (Japan 880722)
mjcamera	Mahjong Camera Kozou (Japan 881109)
mmcamera	(Medal) Mahjong Camera Kozou [BET] (Japan 890509)
idhimitu	Idol no Himitsu [BET] (Japan 890304)
msjiken	Mahjong Satsujin Jiken (Japan 881017)
hanamomo	Mahjong Hana no Momoko gumi (Japan 881201)
telmahjn	Telephone Mahjong (Japan 890111)
gionbana	Gionbana (Japan 890120)
mjfocus	Mahjong Focus (Japan 890313)
mjfocusm	Mahjong Focus [BET] (Japan 890510)
peepshow	Nozokimeguri Mahjong Peep Show (Japan 890404)
scandal	Scandal Mahjong (Japan 890213)
scandalm	Scandal Mahjong [BET] (Japan 890217)
mgmen89	Mahjong G-MEN'89 (Japan 890425)
mjnanpas	Mahjong Nanpa Story (Japan 890713)
mjnanpaa	Mahjong Nanpa Story (Japan 890712)
mjnanpau	Mahjong Nanpa Story (Ura) (Japan 890805)
pairsten	Pairs (System Ten) (Japan 890826)
bananadr	Mahjong Banana Dream [BET] (Japan 891124)
mladyhtr	Mahjong THE LADY HUNTER (Japan 900509)
chinmoku	Mahjong Chinmoku no Hentai (Japan 900511)
maiko	Maikobana (Japan 900802)
club90s	Mahjong CLUB 90's (set 1) (Japan 900919)
club90sa	Mahjong CLUB 90's (set 2) (Japan 900919)
hanaoji	Hana to Ojisan [BET] (Japan 911209)
pstadium	Mahjong Panic Stadium (Japan)
triplew1	Mahjong Triple Wars (Japan)
triplew2	Mahjong Triple Wars 2 (Japan)
ntopstar	Mahjong Nerae! Top Star (Japan)
mjlstory	Mahjong Jikken Love Story (Japan)
vanilla	Mahjong Vanilla Syndrome (Japan)
finalbny	Mahjong Final Bunny [BET] (Japan)
qmhayaku	Quiz-Mahjong Hayaku Yatteyo! (Japan)
galkoku	Mahjong Gal no Kokuhaku (Japan)
hyouban	Mahjong Hyouban Musume [BET] (Japan)
galkaika	Mahjong Gal no Kaika (Japan)
tokyogal	Tokyo Gal Zukan (Japan)
tokimbsj	Tokimeki Bishoujo [BET] (Japan)
mcontest	Miss Mahjong Contest (Japan)
uchuuai	Mahjong Uchuu yori Ai wo komete (Japan)
av2mj1bb	AV2Mahjong No.1 Bay Bridge no Seijo (Japan)
av2mj2rg	AV2Mahjong No.2 Rouge no Kaori (Japan)
mjuraden	Mahjong Uranai Densetsu (Japan)
koinomp	Mahjong Koi no Magic Potion (Japan)
patimono	Mahjong Pachinko Monogatari (Japan)
mjanbari	Medal Mahjong Janjan Baribari [BET] (Japan)
ultramhm	Ultra Maru-hi Mahjong (Japan)
gal10ren	Mahjong Gal 10-renpatsu (Japan)
renaiclb	Mahjong Ren-ai Club (Japan)
mjlaman	Mahjong La Man (Japan)
mkeibaou	Mahjong Keibaou (Japan)
pachiten	Medal Mahjong Pachi-Slot Tengoku [BET] (Japan)
sailorws	Mahjong Sailor Wars (Japan)
sailorwr	Mahjong Sailor Wars-R [BET] (Japan)
psailor1	Bishoujo Janshi Pretty Sailor 18-kin (Japan)
psailor2	Bishoujo Janshi Pretty Sailor 2 (Japan)
otatidai	Disco Mahjong Otachidai no Okite (Japan)
ngpgal	Nekketsu Grand-Prix Gal (Japan)
mjgottsu	Mahjong Gottsu ee-kanji (Japan)
bakuhatu	Mahjong Bakuhatsu Junjouden (Japan)
cmehyou	Mahjong Circuit no Mehyou (Japan)
mmehyou	Medal Mahjong Circuit no Mehyou [BET] (Japan)
mjkoiura	Mahjong Koi Uranai (Japan)
imekura	Imekura Mahjong (Japan)
mscoutm	Mahjong Scout Man (Japan)
mjegolf	Mahjong Erotica Golf (Japan)
niyanpai	Niyanpai (Japan)
safarir	Safari Rally (Japan)
phoenix	Phoenix (Amstar)
phoenixa	Phoenix (Centuri)
phoenixt	Phoenix (Taito)
phoenix3	Phoenix (T.P.N.)
phoenixc	Phoenix (IRECSA, G.G.I Corp)
condor	Condor
falcon	Falcon
vautour	Vautour (Jeutel France)
pleiads	Pleiads (Tehkan)
pleiadbl	Pleiads (bootleg)
pleiadce	Pleiads (Centuri)
capitol	Capitol
survival	Survival
naughtyb	Naughty Boy
naughtya	Naughty Boy (bootleg)
naughtyc	Naughty Boy (Cinematronics)
popflame	Pop Flamer (protected)
popflama	Pop Flamer (not protected)
popflamb	Pop Flamer (hack?)
geebee	Gee Bee
geebeeg	Gee Bee (Gremlin)
bombbee	Bomb Bee
cutieq	Cutie Q
navalone	Navalone
kaitei	Kaitei Takara Sagashi
kaitein	Kaitei Takara Sagashi (Namco)
sos	SOS
tankbatt	Tank Battalion
warpwarp	Warp & Warp
warpwarr	Warp Warp (Rock-ola set 1)
warpwar2	Warp Warp (Rock-ola set 2)
rallyx	Rally X
rallyxm	Rally X (Midway)
nrallyx	New Rally X
nrallyv	New Rally X (Vertical Screen)
jungler	Jungler
junglers	Jungler (Stern)
tactcian	Tactician (set 1)
tactcan2	Tactician (set 2)
locomotn	Loco-Motion
gutangtn	Guttang Gottong
cottong	Cotocoto Cottong
commsega	Commando (Sega)
bosco	Bosconian (new version)
boscoo	Bosconian (old version)
boscoo2	Bosconian (older version)
boscomd	Bosconian (Midway, new version)
boscomdo	Bosconian (Midway, old version)
galaga	Galaga (Namco)
galagamw	Galaga (Midway)
galagads	Galaga (fast shoot)
gallag	Gallag
galagab2	Galaga (bootleg)
galaga84	Galaga '84
nebulbee	Nebulous Bee
gatsbee	Gatsbee
digdug	Dig Dug (set 1)
digdugb	Dig Dug (set 2)
digdugat	Dig Dug (Atari, rev 2)
digduga1	Dig Dug (Atari, rev 1)
dzigzag	Zig Zag (Dig Dug hardware)
xevious	Xevious (Namco)
xeviousa	Xevious (Atari set 1)
xeviousb	Xevious (Atari set 2)
xevios	Xevios
battles	Battles
sxevious	Super Xevious
superpac	Super Pac-Man
superpcm	Super Pac-Man (Midway)
pacnpal	Pac & Pal
pacnpal2	Pac & Pal (older)
pacnchmp	Pac-Man & Chomp Chomp
phozon	Phozon (Japan)
mappy	Mappy (US)
mappyj	Mappy (Japan)
digdug2	Dig Dug II (New Ver.)
digdug2o	Dig Dug II (Old Ver.)
todruaga	Tower of Druaga (New Ver.)
todruago	Tower of Druaga (Old Ver.)
motos	Motos
grobda	Grobda (New version)
grobda2	Grobda (Old version set 1)
grobda3	Grobda (Old version set 2)
gaplus	Gaplus (rev. D)
gaplusa	Gaplus (alternate hardware)
gapluso	Gaplus (rev. B)
galaga3	Galaga 3 (rev. C)
galaga3m	Galaga 3 (Midway)
galaga3a	Galaga 3 (alternate set)
liblrabl	Libble Rabble
toypop	Toypop
polepos	Pole Position
poleposa	Pole Position (Atari version 2)
polepos1	Pole Position (Atari version 1)
topracer	Top Racer
polepos2	Pole Position II
poleps2a	Pole Position II (Atari)
poleps2b	Pole Position II (Atari bootleg 1)
poleps2c	Pole Position II (Atari bootleg 2)
pacland	Pac-Land (set 1)
pacland2	Pac-Land (set 2)
pacland3	Pac-Land (set 3)
paclandm	Pac-Land (Midway)
drgnbstr	Dragon Buster
skykid	Sky Kid (New Ver.)
skykido	Sky Kid (Old Ver.)
skykidd	Sky Kid (60A1 Ver.)
baraduke	Baraduke (set 1)
baraduka	Baraduke (set 2)
metrocrs	Metro-Cross (set 1)
metrocra	Metro-Cross (set 2)
hopmappy	Hopping Mappy
skykiddx	Sky Kid Deluxe (set 1)
skykiddo	Sky Kid Deluxe (set 2)
roishtar	The Return of Ishtar
genpeitd	Genpei ToumaDen
rthunder	Rolling Thunder (new version)
rthundro	Rolling Thunder (old version)
wndrmomo	Wonder Momo
tceptor	Thunder Ceptor
tceptor2	Thunder Ceptor II
shadowld	Shadow Land
youkaidk	Yokai Douchuuki (Japan new version)
yokaidko	Yokai Douchuuki (Japan old version)
dspirit	Dragon Spirit (new version)
dspirito	Dragon Spirit (old version)
blazer	Blazer (Japan)
quester	Quester (Japan)
pacmania	Pac-Mania
pacmanij	Pac-Mania (Japan)
galaga88	Galaga '88 (set 1)
galag88b	Galaga '88 (set 2)
galag88j	Galaga '88 (Japan)
ws	World Stadium (Japan)
berabohm	Beraboh Man (Japan version C)
beraboho	Beraboh Man (Japan version B)
mmaze	Marchen Maze (Japan)
bakutotu	Bakutotsu Kijuutei
wldcourt	World Court (Japan)
splatter	Splatter House (Japan)
faceoff	Face Off (Japan)
rompers	Rompers (Japan)
romperso	Rompers (Japan old version)
blastoff	Blast Off (Japan)
ws89	World Stadium '89 (Japan)
dangseed	Dangerous Seed (Japan)
ws90	World Stadium '90 (Japan)
pistoldm	Pistol Daimyo no Bouken (Japan)
boxyboy	Boxy Boy (US)
soukobdx	Souko Ban Deluxe (Japan)
puzlclub	Puzzle Club (Japan prototype)
tankfrce	Tank Force (US)
tankfrcj	Tank Force (Japan)
finallap	Final Lap (Rev E)
finalapd	Final Lap (Rev D)
finalapc	Final Lap (Rev C)
finlapjc	Final Lap (Japan - Rev C)
finlapjb	Final Lap (Japan - Rev B)
assault	Assault
assaultj	Assault (Japan)
assaultp	Assault Plus (Japan)
metlhawk	Metal Hawk (Japan)
ordyne	Ordyne (Japan)
mirninja	Mirai Ninja (Japan)
phelios	Phelios (Japan)
dirtfoxj	Dirt Fox (Japan)
fourtrax	Four Trax
valkyrie	Valkyrie No Densetsu (Japan)
finehour	Finest Hour (Japan)
burnforc	Burning Force (Japan)
marvland	Marvel Land (US)
marvlanj	Marvel Land (Japan)
kyukaidk	Kyuukai Douchuuki (Japan new version)
kyukaido	Kyuukai Douchuuki (Japan old version)
dsaber	Dragon Saber
dsaberj	Dragon Saber (Japan)
finalap2	Final Lap 2
finalp2j	Final Lap 2 (Japan)
gollygho	Golly! Ghost!
rthun2	Rolling Thunder 2
rthun2j	Rolling Thunder 2 (Japan)
sgunner	Steel Gunner
sgunner2	Steel Gunner 2 (US)
sgunnr2j	Steel Gunner 2 (Japan)
cosmogng	Cosmo Gang the Video (US)
cosmognj	Cosmo Gang the Video (Japan)
finalap3	Final Lap 3 (Japan set 1)
finalp3a	Final Lap 3 (World)
luckywld	Lucky & Wild
suzuka8h	Suzuka 8 Hours (World?)
suzuk8hj	Suzuka 8 Hours (Japan)
sws92	Super World Stadium '92 (Japan)
sws92g	Super World Stadium '92 Gekitouban (Japan)
suzuk8h2	Suzuka 8 Hours 2 (Japan)
sws93	Super World Stadium '93 (Japan)
bkrtmaq	Bakuretsu Quiz Ma-Q Dai Bouken (Japan)
cgangpzl	Cosmo Gang the Puzzle (US)
cgangpzj	Cosmo Gang the Puzzle (Japan)
exvania	Exvania (Japan)
fghtatck	Fighter & Attacker (US)
fa	F/A (Japan)
knckhead	Knuckle Heads (World)
knckhedj	Knuckle Heads (Japan)
swcourt	Super World Court (Japan)
emeralda	Emeraldia (Japan Version B)
emerldaa	Emeraldia (Japan)
numanath	Numan Athletics (World)
numanatj	Numan Athletics (Japan)
quiztou	Nettou! Gekitou! Quiztou!! (Japan)
tinklpit	Tinkle Pit (Japan)
xday2	X-Day 2 (Japan)
nebulray	Nebulas Ray (World)
nebulryj	Nebulas Ray (Japan)
ptblank	Point Blank
gunbulet	Gun Bullet (Japan)
gslgr94u	Great Sluggers '94
sws95	Super World Stadium '95 (Japan)
sws96	Super World Stadium '96 (Japan)
sws97	Super World Stadium '97 (Japan)
vshoot	J-League Soccer V-Shoot
outfxies	Outfoxies
outfxesj	Outfoxies (Japan)
machbrkr	Mach Breakers (Japan)
ncv1	Namco Classics Collection Vol.1
ncv1j	Namco Classics Collection Vol.1 (Japan set 1)
ncv1j2	Namco Classics Collection Vol.1 (Japan set 2)
ncv2	Namco Classics Collection Vol.2
ncv2j	Namco Classics Collection Vol.2 (Japan)
winrun91	Winning Run 91
solvalou	Solvalou (Japan)
starblad	Starblade
aircombj	Air Combat (Japan)
aircombu	Air Combat (US)
cybsled	Cyber Sled
alpinerd	Alpine Racer (Rev. AR2 Ver.D)
alpinerc	Alpine Racer (Rev. AR2 Ver.C)
raveracw	Rave Racer (Rev. RV2, World)
ridgeraj	Ridge Racer (Rev. RR1, Japan)
ridger2j	Ridge Racer 2 (Rev. RRS1, Japan)
acedrvrw	Ace Driver (Rev. AD2, World)
victlapw	Ace Driver: Victory Lap (Rev. ADV2, World)
cybrcomm	Cyber Commando (Rev. CY1, Japan)
airco22b	Air Combat 22 (Rev. ACS1 Ver.B)
cybrcycc	Cyber Cycles (Rev. CB2 Ver.C)
timecrsa	Time Crisis (Rev. TS2 Ver.A)
propcycl	Prop Cycle (Rev PR2 Ver.A)
cosmicg	Cosmic Guerilla
cosmica	Cosmic Alien
cosmica2	Cosmic Alien (older)
panic	Space Panic (version E)
panic2	Space Panic (set 2)
panic3	Space Panic (set 3)
panich	Space Panic (harder)
panicger	Space Panic (German)
zerohour	Zero Hour
redclash	Red Clash
redclask	Red Clash (Kaneko)
magspot	Magical Spot
magspot2	Magical Spot II
devzone	Devil Zone
devzone2	Devil Zone (easier)
nomnlnd	No Man's Land
nomnlndg	No Man's Land (Gottlieb)
cheekyms	Cheeky Mouse
ladybug	Lady Bug
ladybugb	Lady Bug (bootleg)
snapjack	Snap Jack
cavenger	Cosmic Avenger
dorodon	Dorodon (set 1)
dorodon2	Dorodon (set 2)
mrdo	Mr. Do!
mrdoy	Mr. Do! (prototype)
mrdot	Mr. Do! (Taito)
mrdofix	Mr. Do! (bugfixed)
mrlo	Mr. Lo!
mrdu	Mr. Du!
yankeedo	Yankee DO!
docastle	Mr. Do's Castle (set 1)
docastl2	Mr. Do's Castle (set 2)
docastlo	Mr. Do's Castle (older)
douni	Mr. Do vs. Unicorns
dorunrun	Do! Run Run (set 1)
dorunru2	Do! Run Run (set 2)
dorunruc	Do! Run Run (Do's Castle hardware)
spiero	Super Pierrot (Japan)
dowild	Mr. Do's Wild Ride
jjack	Jumping Jack
kickridr	Kick Rider
idsoccer	Indoor Soccer
radarscp	Radar Scope
dkong	Donkey Kong (US set 1)
dkongo	Donkey Kong (US set 2)
dkongjp	Donkey Kong (Japan set 1)
dkongjo	Donkey Kong (Japan set 2)
dkongjo1	Donkey Kong (Japan set 3) (bad dump?)
dkongjr	Donkey Kong Junior (US)
dkongjrj	Donkey Kong Jr. (Japan)
dkngjnrj	Donkey Kong Junior (Japan?)
dkongjrb	Donkey Kong Jr. (bootleg)
dkngjnrb	Donkey Kong Junior (bootleg?)
dkong3	Donkey Kong 3 (US)
dkong3j	Donkey Kong 3 (Japan)
dkong3b	Donkey Kong 3 (bootleg on Donkey Kong Jr. hardware)
mario	Mario Bros. (US)
mariojp	Mario Bros. (Japan)
masao	Masao
pestplce	Pest Place
spclforc	Special Forces
spcfrcii	Special Forces II
8ballact	Eight Ball Action (DK conversion)
8ballat2	Eight Ball Action (DKJr conversion)
shootgal	Shooting Gallery
drakton	Drakton
strtheat	Street Heat - Cardinal Amusements
hunchbkd	Hunchback (DK conversion)
sbdk	Super Bike (DK conversion)
herbiedk	Herbie at the Olympics (DK conversion)
herodk	Hero in the Castle of Doom (DK conversion)
herodku	Hero in the Castle of Doom (DK conversion not encrypted)
skyskipr	Sky Skipper
popeye	Popeye (revision D)
popeyeu	Popeye (revision D not protected)
popeyef	Popeye (revision F)
popeyebl	Popeye (bootleg)
punchout	Punch-Out!!
spnchout	Super Punch-Out!!
spnchotj	Super Punch-Out!! (Japan)
armwrest	Arm Wrestling
pc_tenis	PlayChoice-10: Tennis
pc_mario	PlayChoice-10: Mario Bros.
pc_bball	PlayChoice-10: Baseball
pc_bfght	PlayChoice-10: Balloon Fight
pc_ebike	PlayChoice-10: Excite Bike
pc_golf	PlayChoice-10: Golf
pc_kngfu	PlayChoice-10: Kung Fu
pc_1942	PlayChoice-10: 1942
pc_smb	PlayChoice-10: Super Mario Bros.
pc_vball	PlayChoice-10: Volley Ball
pc_duckh	PlayChoice-10: Duck Hunt
pc_hgaly	PlayChoice-10: Hogan's Alley
pc_wgnmn	PlayChoice-10: Wild Gunman
pc_grdus	PlayChoice-10: Gradius
pc_grdue	PlayChoice-10: Gradius (older)
pc_tkfld	PlayChoice-10: Track & Field
pc_pwrst	PlayChoice-10: Pro Wrestling
pc_trjan	PlayChoice-10: Trojan
pc_cvnia	PlayChoice-10: Castlevania
pc_dbldr	PlayChoice-10: Double Dribble
pc_rnatk	PlayChoice-10: Rush N' Attack
pc_rygar	PlayChoice-10: Rygar
pc_cntra	PlayChoice-10: Contra
pc_goons	PlayChoice-10: The Goonies
pc_mtoid	PlayChoice-10: Metroid
pc_radrc	PlayChoice-10: Rad Racer
pc_miket	PlayChoice-10: Mike Tyson's Punchout
pc_rcpam	PlayChoice-10: RC Pro Am
pc_ngaid	PlayChoice-10: Ninja Gaiden
pc_tmnt	PlayChoice-10: Teenage Mutant Ninja Turtles
pc_ftqst	PlayChoice-10: Uncle Fester's Quest - The Addams Family
pc_bstar	PlayChoice-10: Baseball Stars
pc_tbowl	PlayChoice-10: Tecmo Bowl
pc_drmro	PlayChoice-10: Dr. Mario
pc_ynoid	PlayChoice-10: Yo! Noid
pc_rrngr	PlayChoice-10: Chip'n Dale - Rescue Rangers
pc_ddrgn	PlayChoice-10: Double Dragon
pc_gntlt	PlayChoice-10: Gauntlet
pc_smb2	PlayChoice-10: Super Mario Bros. 2
pc_smb3	PlayChoice-10: Super Mario Bros. 3
pc_mman3	PlayChoice-10: Mega Man 3
pc_radr2	PlayChoice-10: Rad Racer II
pc_suprc	PlayChoice-10: Super C
pc_tmnt2	PlayChoice-10: Teenage Mutant Ninja Turtles II
pc_wcup	PlayChoice-10: Nintendo World Cup
pc_ngai2	PlayChoice-10: Ninja Gaiden 2
pc_ngai3	PlayChoice-10: Ninja Gaiden 3
pc_pwbld	PlayChoice-10: Power Blade
pc_rkats	PlayChoice-10: Rockin' Kats
pc_pinbt	PlayChoice-10: PinBot
pc_cshwk	PlayChoice-10: Captain Sky Hawk
pc_sjetm	PlayChoice-10: Solar Jetman
pc_moglf	PlayChoice-10: Mario's Open Golf
btlecity	Vs. Battle City
starlstr	Vs. Star Luster
cstlevna	Vs. Castlevania
cluclu	Vs. Clu Clu Land
drmario	Vs. Dr. Mario
duckhunt	Vs. Duck Hunt
excitebk	Vs. Excitebike
excitbkj	Vs. Excitebike (Japan)
goonies	Vs. The Goonies
hogalley	Vs. Hogan's Alley
iceclimb	Vs. Ice Climber
iceclmbj	Vs. Ice Climber (Japan)
ladygolf	Vs. Stroke and Match Golf (Ladies Version)
machridr	Vs. Mach Rider (Endurance Course Version)
machridj	Vs. Mach Rider (Japan, Fighting Course Version)
rbibb	Vs. Atari R.B.I. Baseball (set 1)
rbibba	Vs. Atari R.B.I. Baseball (set 2)
suprmrio	Vs. Super Mario Bros.
vsskykid	Vs. Super SkyKid
tkoboxng	Vs. TKO Boxing
smgolf	Vs. Stroke and Match Golf (Men Version)
smgolfj	Vs. Stroke and Match Golf (Men Version) (Japan)
vspinbal	Vs. Pinball
vspinblj	Vs. Pinball (Japan)
vsslalom	Vs. Slalom
vssoccer	Vs. Soccer
vsgradus	Vs. Gradius
platoon	Vs. Platoon
vstetris	Vs. Tetris
mightybj	Vs. Mighty Bomb Jack (Japan)
jajamaru	Vs. Ninja Jajamaru Kun (Japan)
topgun	Vs. Top Gun
bnglngby	Vs. Raid on Bungeling Bay (Japan)
vstennis	Vs. Tennis
wrecking	Vs. Wrecking Crew
balonfgt	Vs. Balloon Fight
vsmahjng	Vs. Mahjang (Japan)
vsbball	Vs. BaseBall
vsbballj	Vs. BaseBall (Japan set 1)
vsbbalja	Vs. BaseBall (Japan set 2)
iceclmrj	Vs. Ice Climber Dual (Japan)
vsgshoe	Vs. Gumshoe
supxevs	Vs. Super Xevious
vsfdf	Vs. Freedom Force
smgolfb	Vs. Stroke and Match Golf (Men set 2)
vsbbaljb	Vs. BaseBall (Japan set 3)
nss_ssoc	Nintendo Super System: Super Soccer
nss_actr	Nintendo Super System: Act Raiser
nss_con3	Nintendo Super System: Contra 3: The Alien Wars
nss_adam	Nintendo Super System: The Addams Family
nss_aten	Nintendo Super System: David Crane's Amazing Tennis
nss_rob3	Nintendo Super System: Robocop 3
nss_ncaa	Nintendo Super System: NCAA Basketball
nss_skin	Nintendo Super System: Skins Game
nss_lwep	Nintendo Super System: Lethal Weapon
nss_smw	Nintendo Super System: Super Mario World
nss_fzer	Nintendo Super System: F-Zero
nss_sten	Nintendo Super System: Super Tennis
seawolf	Sea Wolf
gunfight	Gun Fight
tornbase	Tornado Baseball
280zzzap	Datsun 280 Zzzap
maze	Amazing Maze
boothill	Boot Hill
checkmat	Checkmate
desertgu	Desert Gun
dplay	Double Play
lagunar	Laguna Racer
gmissile	Guided Missile
m4	M-4
clowns	Clowns (rev. 2)
clowns1	Clowns (rev. 1)
einnings	Extra Inning
shuffle	Shuffleboard
dogpatch	Dog Patch
spcenctr	Space Encounters
phantom2	Phantom II
bowler	4 Player Bowling Alley
invaders	Space Invaders
blueshrk	Blue Shark
invad2ct	Space Invaders II (Midway, cocktail)
invadpt2	Space Invaders Part II (Taito)
invaddlx	Space Invaders Deluxe
moonbase	Moon Base
earthinv	Super Earth Invasion
spaceatt	Space Attack
spaceat2	Space Attack II
sinvzen	Super Invaders (Zenitone-Microsec)
superinv	Super Invaders
sstrangr	Space Stranger
sstrngr2	Space Stranger 2
sinvemag	Super Invaders (EMAG)
jspecter	Jatre Specter (set 1)
jspectr2	Jatre Specter (set 2)
invrvnge	Invader's Revenge
invrvnga	Invader's Revenge (Dutchford)
galxwars	Galaxy Wars (Universal set 1)
galxwar2	Galaxy Wars (Universal set 2)
galxwart	Galaxy Wars (Taito?)
starw	Star Wars
lrescue	Lunar Rescue
grescue	Galaxy Rescue
desterth	Destination Earth
cosmicmo	Cosmic Monsters
rollingc	Rolling Crash / Moon Base
sheriff	Sheriff
bandido	Bandido
ozmawars	Ozma Wars (set 1)
ozmawar2	Ozma Wars (set 2)
solfight	Solar Fight
spaceph	Space Phantoms
schaser	Space Chaser
schasrcv	Space Chaser (CV version)
lupin3	Lupin III
helifire	HeliFire (revision B)
helifira	HeliFire (revision A)
spacefev	Space Fever (color)
sfeverbw	Space Fever (black and white)
spclaser	Space Laser
laser	Laser
spcewarl	Space War (Leijac)
polaris	Polaris (set 1)
polarisa	Polaris (set 2)
ballbomb	Balloon Bomber
m79amb	M79 Ambush
alieninv	Alien Invasion Part II
tst_invd	Space Invaders Test ROM
sitv	Space Invaders (TV Version)
sicv	Space Invaders (CV Version)
sisv	Space Invaders (SV Version)
sisv2	Space Invaders (SV Version 2)
spacewr3	Space War Part 3
invaderl	Space Invaders (Logitec)
yosakdon	Yosaku To Donbee (bootleg)
spceking	Space King
spcewars	Space War (Sanritsu)
cosmo	Cosmo
sspeedr	Super Speed Race
sflush	Straight Flush
lazercmd	Lazer Command
bbonk	Bigfoot Bonkers
deadeye	Dead Eye
gypsyjug	Gypsy Juggler
minferno	Inferno (S2650)
medlanes	Meadows Lanes
cosmos	Cosmos
darkwar	Dark Warrior
spacefrt	Space Fortress
8ball	Video Eight Ball
8ball1	Video Eight Ball (Rev.1)
logger	Logger
dazzler	Dazzler
wallst	Wall Street
radarzon	Radar Zone
radarzn1	Radar Zone (Rev.1)
radarznt	Radar Zone (Tuni)
outline	Outline
goldbug	Gold Bug
heartatk	Heart Attack
hunchbak	Hunchback
superbik	Superbike
hero	Hero
huncholy	Hunchback Olympic
seawolf2	Sea Wolf II
spacezap	Space Zap
ebases	Extra Bases
wow	Wizard of Wor
gorf	Gorf
gorfpgm1	Gorf (Program 1)
robby	Robby Roto
profpac	Professor PacMan
solarfox	Solar Fox
kick	Kick (upright)
kicka	Kick (cocktail)
shollow	Satan's Hollow (set 1)
shollow2	Satan's Hollow (set 2)
tron	Tron (set 1)
tron2	Tron (set 2)
kroozr	Kozmik Kroozr
domino	Domino Man
wacko	Wacko
twotiger	Two Tigers
twotigra	Two Tigers (dedicated)
journey	Journey
tapper	Tapper (Budweiser)
tappera	Tapper (alternate)
sutapper	Tapper (Suntory)
rbtapper	Tapper (Root Beer)
timber	Timber
dotron	Discs of Tron (Upright)
dotrona	Discs of Tron (Upright alternate)
dotrone	Discs of Tron (Environmental)
demoderb	Demolition Derby
demoderm	Demolition Derby (2-Player Mono Board Version)
sarge	Sarge
rampage	Rampage (revision 3)
rampage2	Rampage (revision 2)
powerdrv	Power Drive
stargrds	Star Guards
maxrpm	Max RPM
spyhunt	Spy Hunter
turbotag	Turbo Tag (prototype)
crater	Crater Raider
zwackery	Zwackery
xenophob	Xenophobe
spyhunt2	Spy Hunter 2 (rev 2)
spyhnt2a	Spy Hunter 2 (rev 1)
blasted	Blasted
archrivl	Arch Rivals (rev 4.0)
archriv2	Arch Rivals (rev 2.0)
trisport	Tri-Sports
pigskin	Pigskin 621AD
sentetst	Sente Diagnostic Cartridge
cshift	Chicken Shift
gghost	Goalie Ghost
hattrick	Hat Trick
otwalls	Off the Wall (Sente)
snakepit	Snake Pit
snakjack	Snacks'n Jaxson
stocker	Stocker
triviag1	Trivial Pursuit (Genus I)
triviag2	Trivial Pursuit (Genus II)
triviasp	Trivial Pursuit (All Star Sports Edition)
triviayp	Trivial Pursuit (Young Players Edition)
triviabb	Trivial Pursuit (Baby Boomer Edition)
gimeabrk	Gimme A Break
minigolf	Mini Golf (set 1)
minigol2	Mini Golf (set 2)
toggle	Toggle (prototype)
nametune	Name That Tune
nstocker	Night Stocker
sfootbal	Street Football
spiker	Spiker
stompin	Stompin'
rescraid	Rescue Raider
rescrdsa	Rescue Raider (Stand-Alone)
grudge	Grudge Match (prototype)
shrike	Shrike Avenger (prototype)
gridlee	Gridlee
andromed	Andromeda (Japan?)
ipminvad	IPM Invader
skychut	Sky Chuter
spacbeam	Space Beam
greenber	Green Beret (Irem)
redalert	Red Alert
demoneye	Demoneye-X
olibochu	Oli-Boo-Chu
mpatrol	Moon Patrol
mpatrolw	Moon Patrol (Williams)
troangel	Tropical Angel
yard	10 Yard Fight (Japan)
vsyard	10 Yard Fight (Vs. version World, 11/05/84)
vsyard2	10 Yard Fight (Vs. version Japan, set 2)
travrusa	Traverse USA / Zippy Race
motorace	MotoRace USA
shtrider	Shot Rider
wilytowr	Wily Tower
atomboy	Atomic Boy
kungfum	Kung-Fu Master
kungfud	Kung-Fu Master (Data East)
spartanx	Spartan X (Japan)
kungfub	Kung-Fu Master (bootleg set 1)
kungfub2	Kung-Fu Master (bootleg set 2)
battroad	The Battle-Road
ldrun	Lode Runner (set 1)
ldruna	Lode Runner (set 2)
ldrun2	Lode Runner II - The Bungeling Strikes Back
ldrun3	Lode Runner III - The Golden Labyrinth
ldrun3jp	Lode Runner III - Majin No Fukkatsu
ldrun4	Lode Runner IV - Teikoku Karano Dasshutsu
lotlot	Lot Lot
kidniki	Kid Niki - Radical Ninja (US)
yanchamr	Kaiketsu Yanchamaru (Japan)
spelunkr	Spelunker
spelnkrj	Spelunker (Japan)
spelunk2	Spelunker II
horizon	Horizon
youjyudn	Youjyuden (Japan)
vigilant	Vigilante (World)
vigilntu	Vigilante (US)
vigilntj	Vigilante (Japan)
kikcubic	Meikyu Jima (Japan)
rtype	R-Type (Japan)
rtypepj	R-Type (Japan prototype)
rtypeu	R-Type (US)
bchopper	Battle Chopper
mrheli	Mr. HELI no Dai-Bouken
nspirit	Ninja Spirit
nspiritj	Saigo no Nindou (Japan)
imgfight	Image Fight (Japan)
loht	Legend of Hero Tonma
xmultipl	X Multiply (Japan)
dbreed	Dragon Breed
rtype2	R-Type II
rtype2j	R-Type II (Japan)
majtitle	Major Title (Japan)
hharry	Hammerin' Harry (World)
hharryu	Hammerin' Harry (US)
dkgensan	Daiku no Gensan (Japan)
dkgenm72	Daiku no Gensan (Japan, M72)
poundfor	Pound for Pound (World)
poundfou	Pound for Pound (US)
airduel	Air Duel (Japan)
cosmccop	Cosmic Cop (World)
gallop	Gallop - Armed police Unit (Japan)
kengo	Ken-Go
sichuan2	Sichuan II (hack?) (set 1)
sichuana	Sichuan II (hack?) (set 2)
shisen	Shisensho - Joshiryo-Hen (Japan)
matchit	Match It
hasamu	Hasamu (Japan)
dynablst	Dynablaster (World)
dynablsb	Dynablaster (bootleg)
bombrman	Bomberman (Japan)
bbmanw	Bomber Man World (World)
bbmanwj	Bomber Man World (Japan)
atompunk	New Atomic Punk - Global Quest (US)
quizf1	Quiz F-1 1,2finish
riskchal	Risky Challenge
gussun	Gussun Oyoyo (Japan)
shisen2	Shisensho II
gunforce	Gunforce - Battle Fire Engulfed Terror Island (World)
gunforcu	Gunforce - Battle Fire Engulfed Terror Island (US)
gunforcj	Gunforce - Battle Fire Engulfed Terror Island (Japan)
bmaster	Blade Master (World)
lethalth	Lethal Thunder (World)
thndblst	Thunder Blaster (Japan)
uccops	Undercover Cops (World)
uccopsj	Undercover Cops (Japan)
mysticri	Mystic Riders (World)
gunhohki	Gun Hohki (Japan)
majtitl2	Major Title 2 (World)
skingame	The Irem Skins Game (US set 1)
skingam2	The Irem Skins Game (US set 2)
hook	Hook (World)
hooku	Hook (US)
rtypeleo	R-Type Leo (World rev. C)
rtypelej	R-Type Leo (Japan rev. D)
inthunt	In The Hunt (World)
inthuntu	In The Hunt (US)
kaiteids	Kaitei Daisensou (Japan)
nbbatman	Ninja Baseball Batman (US)
leaguemn	Yakyuu Kakutou League-Man (Japan)
ssoldier	Superior Soldiers (US)
psoldier	Perfect Soldiers (Japan)
dsccr94j	Dream Soccer '94 (Japan)
gunforc2	Gunforce 2 (US)
geostorm	Geostorm (Japan)
firebarr	Fire Barrel (Japan)
dsoccr94	Dream Soccer '94
wpksoc	World PK Soccer
reactor	Reactor
mplanets	Mad Planets
mplanuk	Mad Planets (UK)
qbert	Q*bert (US)
qbertjp	Q*bert (Japan)
myqbert	Mello Yello Q*bert
qberttst	Q*bert (early test version)
insector	Insector (prototype)
krull	Krull
sqbert	Faster, Harder, More Challenging Q*bert (prototype)
mach3	M.A.C.H. 3
usvsthem	Us vs. Them
3stooges	The Three Stooges In Brides Is Brides
qbertqub	Q*bert's Qubes
screwloo	Screw Loose (prototype)
curvebal	Curve Ball
qix	Qix (set 1)
qixa	Qix (set 2)
qixb	Qix (set 3)
qix2	Qix II (Tournament)
sdungeon	Space Dungeon
elecyoyo	The Electric Yo-Yo (set 1)
elecyoy2	The Electric Yo-Yo (set 2)
kram	Kram (set 1)
kram2	Kram (set 2)
kram3	Kram (encrypted)
zookeep	Zoo Keeper (set 1)
zookeep2	Zoo Keeper (set 2)
zookeep3	Zoo Keeper (set 3)
slither	Slither (set 1)
slithera	Slither (set 2)
complexx	Complex X
spaceskr	Space Seeker
spacecr	Space Cruiser
junglek	Jungle King (Japan)
junglkj2	Jungle King (Japan, earlier)
jungleh	Jungle Hunt (US)
junglhbr	Jungle Hunt (Brazil)
piratpet	Pirate Pete
alpine	Alpine Ski (set 1)
alpinea	Alpine Ski (set 2)
timetunl	Time Tunnel
wwestern	Wild Western (set 1)
wwester1	Wild Western (set 2)
frontlin	Front Line
elevator	Elevator Action
elevatob	Elevator Action (bootleg)
tinstar	The Tin Star
waterski	Water Ski
bioatack	Bio Attack
hwrace	High Way Race
sfposeid	Sea Fighter Poseidon
kikstart	Kick Start Wheelie King
crbaloon	Crazy Balloon (set 1)
crbalon2	Crazy Balloon (set 2)
sbowling	Strike Bowling
grchamp	Grand Champion
marinedt	Marine Date
bking	Birdie King
bking2	Birdie King 2
bking3	Birdie King 3
chaknpop	Chack'n Pop
josvolly	Joshi Volleyball
gsword	Great Swordsman
pitnrun	Pit & Run
lkage	The Legend of Kage
lkageb	The Legend of Kage (bootleg set 1)
lkageb2	The Legend of Kage (bootleg set 2)
lkageb3	The Legend of Kage (bootleg set 3)
msisaac	Metal Soldier Isaac II
retofinv	Return of the Invaders
retofin1	Return of the Invaders (bootleg set 1)
retofin2	Return of the Invaders (bootleg set 2)
fightrol	Fighting Roller
rollace	Roller Aces (set 1)
rollace2	Roller Aces (set 2)
vsgongf	VS Gong Fight
ringfgt	Ring Fighter (set 1)
ringfgt2	Ring Fighter (set 2)
fieldday	Field Day
undoukai	The Undoukai (Japan)
40love	Forty-Love
tsamurai	Samurai Nihon-ichi (set 1)
tsamura2	Samurai Nihon-ichi (set 2)
nunchaku	Nunchackun
yamagchi	Go Go Mr. Yamaguchi / Yuke Yuke Yamaguchi-kun
m660	Mission 660 (US)
m660j	Mission 660 (Japan)
m660b	Mission 660 (bootleg)
alphaxz	The Alphax Z (Japan)
buggychl	Buggy Challenge
buggycht	Buggy Challenge (Tecfri)
ssrj	Super Speed Race Junior (Japan)
bigevglf	Big Event Golf
flstory	The FairyLand Story
flstoryj	The FairyLand Story (Japan)
onna34ro	Onna Sansirou - Typhoon Gal (set 1)
onna34ra	Onna Sansirou - Typhoon Gal (set 2)
gladiatr	Gladiator (US)
ogonsiro	Ohgon no Siro (Japan)
nycaptor	N.Y. Captor
cyclshtg	Cycle Shooting
benberob	Ben Bero Beh (Japan)
halleys	Halley's Comet (US)
halleysc	Halley's Comet (Japan set 1)
halleycj	Halley's Comet (Japan set 2)
lsasquad	Land Sea Air Squad / Riku Kai Kuu Saizensen
storming	Storming Party / Riku Kai Kuu Saizensen
tokio	Tokio / Scramble Formation
tokiob	Tokio / Scramble Formation (bootleg)
bublbobl	Bubble Bobble
bublbobr	Bubble Bobble (US with mode select)
bubbobr1	Bubble Bobble (US)
boblbobl	Bobble Bobble
sboblbob	Super Bobble Bobble
missb2	Miss Bubble 2
kikikai	KiKi KaiKai
kicknrun	Kick and Run
mexico86	Mexico 86
darius	Darius (World)
dariusj	Darius (Japan)
dariuso	Darius (Japan old version)
dariuse	Darius (Extra) (Japan)
rastan	Rastan (World)
rastanu	Rastan (US set 1)
rastanu2	Rastan (US set 2)
rastsaga	Rastan Saga (Japan)
topspeed	Top Speed (World)
topspedu	Top Speed (US)
fullthrl	Full Throttle (Japan)
opwolf	Operation Wolf (US)
opwolfb	Operation Bear
othunder	Operation Thunderbolt (World)
othundu	Operation Thunderbolt (US)
rainbow	Rainbow Islands (new version)
rainbowo	Rainbow Islands (old version)
rainbowe	Rainbow Islands (Extra)
jumping	Jumping
arkanoid	Arkanoid (World)
arknoidu	Arkanoid (US)
arknoiuo	Arkanoid (US, older)
arknoidj	Arkanoid (Japan)
arkbl2	Arkanoid (Japanese bootleg Set 2)
arkbl3	Arkanoid (Japanese bootleg Set 3)
paddle2	Paddle 2
arkatayt	Arkanoid (Tayto bootleg, Japanese)
arkblock	Block (bootleg, Japanese)
arkbloc2	Block (Game Corporation bootleg)
arkangc	Arkanoid (Game Corporation bootleg)
arkatour	Tournament Arkanoid (US)
superqix	Super Qix
sqixbl	Super Qix (bootleg)
perestro	Perestroika Girls
pbillian	Prebillian
hotsmash	Hot Smash
exzisus	Exzisus (Japan)
minivadr	Minivader
volfied	Volfied (World)
volfiedu	Volfied (US)
volfiedj	Volfied (Japan)
bonzeadv	Bonze Adventure (World)
bonzeadu	Bonze Adventure (US)
jigkmgri	Jigoku Meguri (Japan)
asuka	Asuka & Asuka (Japan)
mofflott	Maze of Flott (Japan)
cadash	Cadash (World)
cadashj	Cadash (Japan)
cadashu	Cadash (US)
cadashi	Cadash (Italy)
cadashf	Cadash (France)
galmedes	Galmedes (Japan)
earthjkr	U.N. Defense Force: Earth Joker (Japan)
eto	Kokontouzai Eto Monogatari (Japan)
wgp	World Grand Prix (US)
wgpj	World Grand Prix (Japan)
wgpjoy	World Grand Prix (joystick version set 1) (Japan)
wgpjoya	World Grand Prix (joystick version set 2) (Japan)
wgp2	World Grand Prix 2 (Japan)
slapshot	Slap Shot (Japan)
opwolf3	Operation Wolf 3 (World)
opwolf3u	Operation Wolf 3 (US)
ashnojoe	Ashita no Joe (Japan)
ninjaw	The Ninja Warriors (World)
ninjawj	The Ninja Warriors (Japan)
darius2	Darius II (Japan)
darius2d	Darius II (dual screen) (Japan)
drius2do	Darius II (dual screen) (Japan old version)
warriorb	Warrior Blade - Rastan Saga Episode III (Japan)
superman	Superman
twinhawk	Twin Hawk (World)
twinhwku	Twin Hawk (US)
daisenpu	Daisenpu (Japan)
gigandes	Gigandes
kyustrkr	Last Striker / Kyuukyoku no Striker
ballbros	Balloon Brothers
plumppop	Plump Pop (Japan)
extrmatn	Extermination (US)
arknoid2	Arkanoid - Revenge of DOH (World)
arknid2u	Arkanoid - Revenge of DOH (US)
arknid2j	Arkanoid - Revenge of DOH (Japan)
drtoppel	Dr. Toppel's Adventure (World)
drtopplu	Dr. Toppel's Adventure (US)
drtopplj	Dr. Toppel's Tankentai (Japan)
kageki	Kageki (US)
kagekij	Kageki (Japan)
chukatai	Chuka Taisen (World)
chukatau	Chuka Taisen (US)
chukataj	Chuka Taisen (Japan)
tnzs	The NewZealand Story (Japan)
tnzsb	The NewZealand Story (World, bootleg)
tnzs2	The NewZealand Story 2 (World)
insectx	Insector X (World)
raimais	Raimais (Japan)
kurikint	Kuri Kinton (World)
kurikinu	Kuri Kinton (US)
kurikinj	Kuri Kinton (Japan)
kurikina	Kuri Kinton (World, prototype?)
evilston	Evil Stone
fhawk	Fighting Hawk (World)
fhawkj	Fighting Hawk (Japan)
plotting	Plotting (World)
champwr	Champion Wrestler (World)
champwru	Champion Wrestler (US)
champwrj	Champion Wrestler (Japan)
puzznic	Puzznic (Japan)
horshoes	American Horseshoes (US)
palamed	Palamedes (Japan)
cachat	Cachat (Japan)
tubeit	Tube-It
cubybop	Cuby Bop (Location Test)
plgirls	Play Girls
plgirls2	Play Girls 2
syvalion	Syvalion (Japan)
recordbr	Recordbreaker (World)
dleague	Dynamite League (Japan)
masterw	Master of Weapon (World)
nastar	Nastar (World)
nastarw	Nastar Warrior (US)
rastsag2	Rastan Saga 2 (Japan)
rambo3	Rambo III (Europe set 1)
rambo3ae	Rambo III (Europe set 2)
rambo3a	Rambo III (US)
crimec	Crime City (World)
crimecu	Crime City (US)
crimecj	Crime City (Japan)
tetrist	Tetris (Japan, B-System)
viofight	Violence Fight (World)
ashura	Ashura Blaster (Japan)
ashurau	Ashura Blaster (US)
hitice	Hit the Ice (US)
sbm	Sonic Blast Man (Japan)
selfeena	Sel Feena
silentd	Silent Dragon (World)
silentdj	Silent Dragon (Japan)
ryujin	Ryu Jin (Japan)
qzshowby	Quiz Sekai wa SHOW by shobai (Japan)
pbobble	Puzzle Bobble (Japan, B-System)
spacedx	Space Invaders DX (US) v2.1
spacedxj	Space Invaders DX (Japan) v2.1
spacedxo	Space Invaders DX (Japan) v2.0
contcirc	Continental Circus (World)
contcrcu	Continental Circus (US)
chasehq	Chase H.Q. (World)
chasehqj	Chase H.Q. (Japan)
enforce	Enforce (Japan)
nightstr	Night Striker (US)
sci	Special Criminal Investigation (World set 1)
scia	Special Criminal Investigation (World set 2)
sciu	Special Criminal Investigation (US)
bshark	Battle Shark (US)
bsharkj	Battle Shark (Japan)
aquajack	Aqua Jack (World)
aquajckj	Aqua Jack (Japan)
spacegun	Space Gun (World)
dblaxle	Double Axle (US)
pwheelsj	Power Wheels (Japan)
topland	Top Landing (World)
ainferno	Air Inferno (US)
gunbustr	Gunbuster (Japan)
superchs	Super Chase - Criminal Termination (US)
groundfx	Ground Effects / Super Ground Effects (Japan)
undrfire	Under Fire (World)
undrfiru	Under Fire (US)
undrfirj	Under Fire (Japan)
finalb	Final Blow (World)
finalbj	Final Blow (Japan)
dondokod	Don Doko Don (World)
dondokdu	Don Doko Don (US)
dondokdj	Don Doko Don (Japan)
megab	Mega Blast (World)
megabj	Mega Blast (Japan)
thundfox	Thunder Fox (World)
thndfoxu	Thunder Fox (US)
thndfoxj	Thunder Fox (Japan)
cameltry	Cameltry (US)
camltrua	Cameltry (US, alt sound)
cameltrj	Cameltry (Japan)
qtorimon	Quiz Torimonochou (Japan)
liquidk	Liquid Kids (World)
liquidku	Liquid Kids (US)
mizubaku	Mizubaku Daibouken (Japan)
quizhq	Quiz H.Q. (Japan)
ssi	Super Space Invaders '91 (World)
majest12	Majestic Twelve - The Space Invaders Part IV (Japan)
gunfront	Gun & Frontier (World)
gunfronj	Gun Frontier (Japan)
growl	Growl (World)
growlu	Growl (US)
runark	Runark (Japan)
mjnquest	Mahjong Quest (Japan)
mjnquesb	Mahjong Quest (No Nudity)
footchmp	Football Champ (World)
hthero	Hat Trick Hero (Japan)
euroch92	Euro Champ '92 (World)
koshien	Ah Eikou no Koshien (Japan)
yuyugogo	Yuuyu no Quiz de GO!GO! (Japan)
ninjak	The Ninja Kids (World)
ninjakj	The Ninja Kids (Japan)
solfigtr	Solitary Fighter (World)
qzquest	Quiz Quest - Hime to Yuusha no Monogatari (Japan)
pulirula	PuLiRuLa (World)
pulirulj	PuLiRuLa (Japan)
metalb	Metal Black (World)
metalbj	Metal Black (Japan)
qzchikyu	Quiz Chikyu Bouei Gun (Japan)
yesnoj	Yes/No Sinri Tokimeki Chart
deadconx	Dead Connection (World)
deadconj	Dead Connection (Japan)
dinorex	Dino Rex (World)
dinorexj	Dino Rex (Japan)
dinorexu	Dino Rex (US)
qjinsei	Quiz Jinsei Gekijoh (Japan)
qcrayon	Quiz Crayon Shinchan (Japan)
qcrayon2	Crayon Shinchan Orato Asobo (Japan)
driftout	Drift Out (Japan)
driveout	Drive Out
ringrage	Ring Rage (World)
ringragj	Ring Rage (Japan)
ringragu	Ring Rage (US)
arabianm	Arabian Magic (World)
arabiamj	Arabian Magic (Japan)
arabiamu	Arabian Magic (US)
ridingf	Riding Fight (World)
ridefgtj	Riding Fight (Japan)
ridefgtu	Riding Fight (US)
gseeker	Grid Seeker: Project Stormhammer (World)
gseekerj	Grid Seeker: Project Stormhammer (Japan)
gseekeru	Grid Seeker: Project Stormhammer (US)
hthero93	Hat Trick Hero '93 (Japan)
cupfinal	Taito Cup Finals (World)
trstar	Top Ranking Stars (World new version)
trstarj	Top Ranking Stars (Japan new version)
prmtmfgt	Prime Time Fighter (US new version)
trstaro	Top Ranking Stars (World old version)
trstaroj	Top Ranking Stars (Japan old version)
prmtmfgo	Prime Time Fighter (US old version)
gunlock	Gunlock (World)
rayforcj	Rayforce (Japan)
rayforce	Rayforce (US)
scfinals	Super Cup Finals (World)
intcup94	International Cup '94
dungeonm	Dungeon Magic (World)
lightbr	Light Bringer (Japan)
dungenmu	Dungeon Magic (US)
kaiserkn	Kaiser Knuckle (World)
kaiserkj	Kaiser Knuckle (Japan)
gblchmp	Global Champion (US)
dankuga	Dan-Ku-Ga (Prototype)
dariusg	Darius Gaiden - Silver Hawk (World)
dariusgj	Darius Gaiden - Silver Hawk (Japan)
dariusgu	Darius Gaiden - Silver Hawk (US)
dariusgx	Darius Gaiden - Silver Hawk (Extra Version) [Official Hack]
bublbob2	Bubble Bobble 2 (World)
bubsympe	Bubble Symphony (Europe)
bubsympu	Bubble Symphony (US)
bubsymph	Bubble Symphony (Japan)
spcinvdj	Space Invaders DX (Japan F3 version)
pwrgoal	Taito Power Goal (World)
hthero95	Hat Trick Hero '95 (Japan)
hthro95u	Hat Trick Hero '95 (US)
qtheater	Quiz Theater - 3tsu no Monogatari (Japan)
elvactr	Elevator Action Returns (World)
elvactrj	Elevator Action Returns (Japan)
elvact2u	Elevator Action 2 (US)
spcinv95	Space Invaders '95 - Attack Of The Lunar Loonies (World)
spcnv95u	Space Invaders '95 - Attack Of The Lunar Loonies (US)
akkanvdr	Akkanvader (Japan)
twinqix	Twin Qix (US Prototype)
quizhuhu	Moriguchi Hiroko no Quiz de Hyuu!Hyuu! (Japan)
pbobble2	Puzzle Bobble 2 (World)
pbobbl2j	Puzzle Bobble 2 (Japan)
pbobbl2u	Bust-A-Move Again (US)
pbobbl2x	Puzzle Bobble 2X (Japan)
gekirido	Gekirindan (Japan)
ktiger2	Kyukyoku Tiger 2 (Japan)
bubblem	Bubble Memories - The Story Of Bubble Bobble 3 (World)
bubblemj	Bubble Memories - The Story Of Bubble Bobble 3 (Japan)
cleopatr	Cleopatra Fortune (Japan)
pbobble3	Puzzle Bobble 3 (World)
pbobbl3u	Puzzle Bobble 3 (US)
pbobbl3j	Puzzle Bobble 3 (Japan)
arkretrn	Arkanoid Returns (Japan)
kirameki	Kirameki Star Road (Japan)
puchicar	Puchi Carat (Japan)
pbobble4	Puzzle Bobble 4 (World)
pbobbl4j	Puzzle Bobble 4 (Japan)
pbobbl4u	Puzzle Bobble 4 (US)
popnpop	Pop 'N Pop (World)
popnpopj	Pop 'N Pop (Japan)
popnpopu	Pop 'N Pop (US)
landmakr	Land Maker (Japan)
landmkrp	Land Maker (World Prototype)
perfrman	Performan (Japan)
perfrmau	Performan (US)
tigerh	Tiger Heli (US)
tigerh2	Tiger Heli (Japan set 1)
tigerhj	Tiger Heli (Japan set 2)
tigerhb1	Tiger Heli (bootleg set 1)
tigerhb2	Tiger Heli (bootleg set 2)
slapfigh	Slap Fight
slapbtjp	Slap Fight (Japan bootleg)
slapbtuk	Slap Fight (English bootleg)
alcon	Alcon
getstar	Guardian
getstarj	Get Star (Japan)
getstarb	Get Star (bootleg)
mjsister	Mahjong Sisters (Japan)
fshark	Flying Shark (World)
skyshark	Sky Shark (US)
hishouza	Hishou Zame (Japan)
fsharkbt	Flying Shark (bootleg)
wardner	Wardner (World)
pyros	Pyros (US)
wardnerj	Wardner no Mori (Japan)
twincobr	Twin Cobra (World)
twincobu	Twin Cobra (US)
ktiger	Kyukyoku Tiger (Japan)
gulfwar2	Gulf War II
rallybik	Rally Bike / Dash Yarou
truxton	Truxton / Tatsujin
hellfire	Hellfire
hellfir1	Hellfire (1P Ver.)
zerowing	Zero Wing
demonwld	Demon's World / Horror Story
demonwl1	Demon's World / Horror Story (Taito license)
fireshrk	Fire Shark
samesame	Same! Same! Same!
samesam2	Same! Same! Same! (2P Ver.)
outzone	Out Zone (set 1)
outzonea	Out Zone (set 2)
vimana	Vimana
vimana1	Vimana (old set)
vimanan	Vimana (Nova Apparate GMBH & Co)
snowbros	Snow Bros. - Nick & Tom (set 1)
snowbroa	Snow Bros. - Nick & Tom (set 2)
snowbrob	Snow Bros. - Nick & Tom (set 3)
snowbroj	Snow Bros. - Nick & Tom (Japan)
wintbob	The Winter Bobble
hyperpac	Hyper Pacman
hyperpcb	Hyper Pacman (bootleg)
moremorp	More More +
3in1semi	3-in-1 (SemiCom)
4in1boot	4-in-1 bootleg
cookbib2	Cookie and Bibi 2
tekipaki	Teki Paki
ghox	Ghox
dogyuun	Dogyuun
kbash	Knuckle Bash
truxton2	Truxton II / Tatsujin II / Tatsujin Oh (Japan)
pipibibs	Pipi & Bibis / Whoopee!!
whoopee	Whoopee!! / Pipi & Bibis
pipibibi	Pipi & Bibis / Whoopee!! (bootleg ?)
fixeight	FixEight
vfive	V-Five (Japan)
grindstm	Grind Stormer
grindsta	Grind Stormer (older set)
batsugun	Batsugun
batugnsp	Batsugun (Special Ver.)
snowbro2	Snow Bros. 2 - With New Elves / Otenki Paradise
sstriker	Sorcer Striker (World)
mahoudai	Mahou Daisakusen (Japan)
shippumd	Shippu Mahou Daisakusen (Japan)
kingdmgp	Kingdom Grandprix (World)
battleg	Battle Garegga - Type 2 (Denmark / China) (Tue Apr 2 1996)
battlega	Battle Garegga (Europe / USA / Japan / Asia) (Sat Feb 3 1996)
battlegb	Battle Garegga (Austria / Hong Kong) (Sat Mar 2 1996)
batrider	Armed Police Batrider (Japan, version B)
batridra	Armed Police Batrider (Japan, version A)
batridrk	Armed Police Batrider (Korea, version B)
bbakraid	Battle Bakraid (Japan) (Wed Apr 7 1999)
bbakradu	Battle Bakraid - Unlimited version (Japan) (Tue Jun 8 1999)
pwrinst2	Power Instinct 2 (USA)
mazinger	Mazinger Z
donpachi	DonPachi (US)
donpachj	DonPachi (Japan)
donpachk	DonPachi (Korea)
metmqstr	Metamoqester
nmaster	Oni - The Ninja Master (Japan)
sailormn	Pretty Soldier Sailor Moon (95/03/22B)
sailormo	Pretty Soldier Sailor Moon (95/03/22)
agallet	Air Gallet
hotdogst	Hotdog Storm
ddonpach	DoDonPachi (International)
ddonpchj	DoDonPachi (Japan)
dfeveron	Dangun Feveron (Japan)
esprade	ESP Ra.De. (International Ver 1998 4/22)
espradej	ESP Ra.De. (Japan Ver 1998 4/21)
espradeo	ESP Ra.De. (Japan Ver 1998 4/14)
uopoko	Uo Poko (Japan)
guwange	Guwange (Japan)
gaia	Gaia Crusaders
gyrodine	Gyrodine
sonofphx	Son of Phoenix
repulse	Repulse
99lstwar	'99: The Last War
99lstwra	'99: The Last War (alternate)
flashgal	Flashgal
srdmissn	S.R.D. Mission
legend	Legend
airwolf	Airwolf
skywolf	Sky Wolf (set 1)
skywolf2	Sky Wolf (set 2)
defender	Defender (Red label)
defendg	Defender (Green label)
defendw	Defender (White label)
defndjeu	Defender ? (bootleg)
defcmnd	Defense Command (set 1)
defence	Defence Command
mayday	Mayday (set 1)
maydaya	Mayday (set 2)
maydayb	Mayday (set 3)
colony7	Colony 7 (set 1)
colony7a	Colony 7 (set 2)
stargate	Stargate
robotron	Robotron (Solid Blue label)
robotryo	Robotron (Yellow/Orange label)
joust	Joust (White/Green label)
joustr	Joust (Solid Red label)
joustwr	Joust (White/Red label)
bubbles	Bubbles
bubblesr	Bubbles (Solid Red label)
bubblesp	Bubbles (prototype version)
splat	Splat!
sinistar	Sinistar (revision 3)
sinista1	Sinistar (prototype version)
sinista2	Sinistar (revision 2)
playball	PlayBall! (prototype)
blaster	Blaster
blastkit	Blaster (kit)
spdball	Speed Ball (prototype)
mysticm	Mystic Marathon
tshoot	Turkey Shoot
inferno	Inferno
joust2	Joust 2 - Survival of the Fittest (set 1)
lottofun	Lotto Fun
vulgus	Vulgus (set 1)
vulgus2	Vulgus (set 2)
vulgusj	Vulgus (Japan?)
sonson	Son Son
sonsonj	Son Son (Japan)
higemaru	Pirate Ship Higemaru
1942	1942 (set 1)
1942a	1942 (set 2)
1942b	1942 (set 3)
exedexes	Exed Exes
savgbees	Savage Bees
commando	Commando (World)
commandu	Commando (US)
commandj	Senjou no Ookami
sinvasn	Space Invasion (Europe)
sinvasnb	Space Invasion (bootleg)
gng	Ghosts'n Goblins (World? set 1)
gnga	Ghosts'n Goblins (World? set 2)
gngt	Ghosts'n Goblins (US)
makaimur	Makai-Mura (Japan)
makaimuc	Makai-Mura (Japan Revision C)
makaimug	Makai-Mura (Japan Revision G)
diamond	Diamond Run
gunsmoke	Gun.Smoke (World)
gunsmoku	Gun.Smoke (US set 1)
gunsmoka	Gun.Smoke (US set 2)
gunsmokj	Gun.Smoke (Japan)
sectionz	Section Z (set 1)
sctionza	Section Z (set 2)
trojan	Trojan (US)
trojanr	Trojan (Romstar)
trojanj	Tatakai no Banka (Japan)
srumbler	The Speed Rumbler (set 1)
srumblr2	The Speed Rumbler (set 2)
rushcrsh	Rush & Crash (Japan)
lwings	Legendary Wings (US set 1)
lwings2	Legendary Wings (US set 2)
lwingsjp	Ares no Tsubasa (Japan)
sidearms	Side Arms - Hyper Dyne (World)
sidearmr	Side Arms - Hyper Dyne (US)
sidearjp	Side Arms - Hyper Dyne (Japan)
turtship	Turtle Ship
dyger	Dyger (Korea set 1)
dygera	Dyger (Korea set 2)
whizz	Whizz
avengers	Avengers (US set 1)
avenger2	Avengers (US set 2)
buraiken	Hissatsu Buraiken (Japan)
bionicc	Bionic Commando (US set 1)
bionicc2	Bionic Commando (US set 2)
topsecrt	Top Secret (Japan)
1943	1943 - The Battle of Midway (US)
1943j	1943 - The Battle of Midway (Japan)
blktiger	Black Tiger
bktigerb	Black Tiger (bootleg)
blkdrgon	Black Dragon
blkdrgnb	Black Dragon (bootleg)
sf1	Street Fighter (World)
sf1us	Street Fighter (US)
sf1jp	Street Fighter (Japan)
sf1p	Street Fighter (prototype)
tigeroad	Tiger Road (US)
toramich	Tora-he no Michi (Japan)
f1dream	F-1 Dream
f1dreamb	F-1 Dream (bootleg)
1943kai	1943 Kai - Midway Kaisen
lastduel	Last Duel (US set 1)
lstduela	Last Duel (US set 2)
lstduelb	Last Duel (bootleg)
madgear	Mad Gear (US)
madgearj	Mad Gear (Japan)
ledstorm	Led Storm (US)
forgottn	Forgotten Worlds (US)
lostwrld	Lost Worlds (Japan)
ghouls	Ghouls'n Ghosts (World)
ghoulsu	Ghouls'n Ghosts (US)
daimakai	Dai Makai-Mura (Japan)
strider	Strider (US set 1)
stridrua	Strider (US set 2)
striderj	Strider Hiryu (Japan set 1)
stridrja	Strider Hiryu (Japan set 2)
dw	Dynasty Wars (World)
dwj	Tenchi wo Kurau (Japan)
willow	Willow (US)
willowj	Willow (Japan, Japanese)
willowje	Willow (Japan, English)
unsquad	U.N. Squadron (US)
area88	Area 88 (Japan)
ffight	Final Fight (World)
ffightu	Final Fight (US 900112)
ffightj	Final Fight (Japan set 1)
ffightj1	Final Fight (Japan set 2)
1941	1941 - Counter Attack (World)
1941j	1941 - Counter Attack (Japan)
mercs	Mercs (World 900302)
mercsu	Mercs (US 900302)
mercsua	Mercs (US 900608)
mercsj	Senjou no Ookami II (Japan 900302)
mtwins	Mega Twins (World 900619)
chikij	Chiki Chiki Boys (Japan 900619)
msword	Magic Sword - Heroic Fantasy (World 900725)
mswordr1	Magic Sword - Heroic Fantasy (World 900623)
mswordu	Magic Sword - Heroic Fantasy (US 900725)
mswordj	Magic Sword (Japan 900623)
cawing	Carrier Air Wing (World 901012)
cawingu	Carrier Air Wing (US 901012)
cawingj	U.S. Navy (Japan 901012)
nemo	Nemo (World 901130)
nemoj	Nemo (Japan 901120)
sf2	Street Fighter II - The World Warrior (World 910522)
sf2eb	Street Fighter II - The World Warrior (World 910214)
sf2ua	Street Fighter II - The World Warrior (US 910206)
sf2ub	Street Fighter II - The World Warrior (US 910214)
sf2ud	Street Fighter II - The World Warrior (US 910318)
sf2ue	Street Fighter II - The World Warrior (US 910228)
sf2uf	Street Fighter II - The World Warrior (US 910411)
sf2ui	Street Fighter II - The World Warrior (US 910522)
sf2uk	Street Fighter II - The World Warrior (US 911101)
sf2j	Street Fighter II - The World Warrior (Japan 911210)
sf2ja	Street Fighter II - The World Warrior (Japan 910214)
sf2jc	Street Fighter II - The World Warrior (Japan 910306)
3wonders	Three Wonders (World 910520)
3wonderu	Three Wonders (US 910520)
wonder3	Wonder 3 (Japan 910520)
kod	The King of Dragons (World 910711)
kodu	The King of Dragons (US 910910)
kodj	The King of Dragons (Japan 910805)
kodb	The King of Dragons (bootleg)
captcomm	Captain Commando (World 911014)
captcomu	Captain Commando (US 910928)
captcomj	Captain Commando (Japan 911202)
knights	Knights of the Round (World 911127)
knightsu	Knights of the Round (US 911127)
knightsj	Knights of the Round (Japan 911127)
sf2ce	Street Fighter II' - Champion Edition (World 920313)
sf2ceua	Street Fighter II' - Champion Edition (US 920313)
sf2ceub	Street Fighter II' - Champion Edition (US 920513)
sf2ceuc	Street Fighter II' - Champion Edition (US 920803)
sf2cej	Street Fighter II' - Champion Edition (Japan 920513)
sf2rb	Street Fighter II' - Champion Edition (Rainbow set 1)
sf2rb2	Street Fighter II' - Champion Edition (Rainbow set 2)
sf2red	Street Fighter II' - Champion Edition (Red Wave)
sf2v004	Street Fighter II! - Champion Edition (V004)
sf2accp2	Street Fighter II' - Champion Edition (Accelerator Pt.II)
sf2m1	Street Fighter II' - Champion Edition (M1)
sf2m2	Street Fighter II' - Champion Edition (M2)
sf2m3	Street Fighter II' - Champion Edition (M3)
sf2m4	Street Fighter II' - Champion Edition (M4)
sf2m5	Street Fighter II' - Champion Edition (M5)
sf2m6	Street Fighter II' - Champion Edition (M6)
sf2m7	Street Fighter II' - Champion Edition (M7)
sf2yyc	Street Fighter II' - Champion Edition (YYC)
sf2koryu	Street Fighter II' - Champion Edition (Kouryu)
varth	Varth - Operation Thunderstorm (World 920612)
varthu	Varth - Operation Thunderstorm (US 920612)
varthj	Varth - Operation Thunderstorm (Japan 920714)
cworld2j	Capcom World 2 (Japan 920611)
wof	Warriors of Fate (World 921002)
wofa	Sangokushi II (Asia 921005)
wofu	Warriors of Fate (US 921031)
wofj	Tenchi wo Kurau II - Sekiheki no Tatakai (Japan 921031)
sf2t	Street Fighter II' - Hyper Fighting (US 921209)
sf2tj	Street Fighter II' Turbo - Hyper Fighting (Japan 921209)
dino	Cadillacs and Dinosaurs (World 930201)
dinou	Cadillacs and Dinosaurs (US 930201)
dinoj	Cadillacs Kyouryuu-Shinseiki (Japan 930201)
punisher	The Punisher (World 930422)
punishru	The Punisher (US 930422)
punishrj	The Punisher (Japan 930422)
slammast	Saturday Night Slam Masters (World 930713)
slammasu	Saturday Night Slam Masters (US 930713)
mbomberj	Muscle Bomber - The Body Explosion (Japan 930713)
mbombrd	Muscle Bomber Duo - Ultimate Team Battle (World 931206)
mbombrdj	Muscle Bomber Duo - Heat Up Warriors (Japan 931206)
pnickj	Pnickies (Japan 940608)
qad	Quiz & Dragons (US 920701)
qadj	Quiz & Dragons (Japan 940921)
qtono2	Quiz Tonosama no Yabou 2 Zenkoku-ban (Japan 950123)
pang3	Pang! 3 (Euro 950511)
pang3j	Pang! 3 (Japan 950511)
megaman	Mega Man - The Power Battle (CPS1 Asia 951006)
rockmanj	Rockman - The Power Battle (CPS1 Japan 950922)
ssf2	Super Street Fighter 2: The New Challengers (World 930911)
ssf2u	Super Street Fighter 2: The New Challengers (US 930911)
ssf2a	Super Street Fighter 2: The New Challengers (Asia 931005)
ssf2ar1	Super Street Fighter 2: The New Challengers (Asia 930914)
ssf2j	Super Street Fighter 2: The New Challengers (Japan 931005)
ssf2jr1	Super Street Fighter 2: The New Challengers (Japan 930911)
ssf2jr2	Super Street Fighter 2: The New Challengers (Japan 930910)
ssf2tb	Super Street Fighter 2: The Tournament Battle (World 931119)
ssf2tbj	Super Street Fighter 2: The Tournament Battle (Japan 930910)
ecofghtr	Eco Fighters (World 931203)
ecofghta	Eco Fighters (Asia 931203)
uecology	Ultimate Ecology (Japan 931203)
ddtod	Dungeons & Dragons: Tower of Doom (Euro 940412)
ddtodu	Dungeons & Dragons: Tower of Doom (US 940125)
ddtodur1	Dungeons & Dragons: Tower of Doom (US 940113)
ddtodj	Dungeons & Dragons: Tower of Doom (Japan 940113)
ddtoda	Dungeons & Dragons: Tower of Doom (Asia 940113)
ddtodh	Dungeons & Dragons: Tower of Doom (Hispanic 940125)
ssf2t	Super Street Fighter 2 Turbo (World 940223)
ssf2tu	Super Street Fighter 2 Turbo (US 940323)
ssf2tur1	Super Street Fighter 2 Turbo (US 940223)
ssf2ta	Super Street Fighter 2 Turbo (Asia 940223)
ssf2xj	Super Street Fighter 2 X: Grand Master Challenge (Japan 940223)
avsp	Alien vs. Predator (Euro 940520)
avspu	Alien vs. Predator (US 940520)
avspj	Alien vs. Predator (Japan 940520)
avspa	Alien vs. Predator (Asia 940520)
dstlk	Darkstalkers: The Night Warriors (Euro 940705)
dstlku	Darkstalkers: The Night Warriors (US 940818)
dstlkur1	Darkstalkers: The Night Warriors (US 940705)
dstlka	Darkstalkers: The Night Warriors (Asia 940705)
vampj	Vampire: The Night Warriors (Japan 940705)
vampja	Vampire: The Night Warriors (Japan 940705 alt)
vampjr1	Vampire: The Night Warriors (Japan 940630)
ringdest	Ring of Destruction: Slammasters II (Euro 940902)
smbomb	Super Muscle Bomber: The International Blowout (Japan 940831)
smbombr1	Super Muscle Bomber: The International Blowout (Japan 940808)
armwar	Armored Warriors (Euro 941011)
armwaru	Armored Warriors (US 941024)
pgear	Powered Gear: Strategic Variant Armor Equipment (Japan 941024)
pgearr1	Powered Gear: Strategic Variant Armor Equipment (Japan 940916)
armwara	Armored Warriors (Asia 940920)
xmcota	X-Men: Children of the Atom (Euro 950105)
xmcotau	X-Men: Children of the Atom (US 950105)
xmcotah	X-Men: Children of the Atom (Hispanic 950331)
xmcotaj	X-Men: Children of the Atom (Japan 941219)
xmcotaj1	X-Men: Children of the Atom (Japan 941217)
xmcotaa	X-Men: Children of the Atom (Asia 941217)
xmcotajr	X-Men: Children of the Atom (Japan 941208 rent version)
nwarr	Night Warriors: Darkstalkers' Revenge (US 950406)
nwarrh	Night Warriors: Darkstalkers' Revenge (Hispanic 950403)
nwarrb	Night Warriors: Darkstalkers' Revenge (Brazil 950403)
vhuntj	Vampire Hunter: Darkstalkers' Revenge (Japan 950316)
vhuntjr1	Vampire Hunter: Darkstalkers' Revenge (Japan 950302)
cybots	Cyberbots: Fullmetal Madness (US 950424)
cybotsj	Cyberbots: Fullmetal Madness (Japan 950420)
sfa	Street Fighter Alpha: Warriors' Dreams (Euro 950727)
sfar1	Street Fighter Alpha: Warriors' Dreams (Euro 950718)
sfar2	Street Fighter Alpha: Warriors' Dreams (Euro 950605)
sfau	Street Fighter Alpha: Warriors' Dreams (US 950627)
sfzj	Street Fighter Zero (Japan 950727)
sfzjr1	Street Fighter Zero (Japan 950627)
sfzjr2	Street Fighter Zero (Japan 950605)
sfzh	Street Fighter Zero (Hispanic 950627)
sfzb	Street Fighter Zero (Brazil 951109)
msh	Marvel Super Heroes (Euro 951024)
mshu	Marvel Super Heroes (US 951024)
mshj	Marvel Super Heroes (Japan 951024)
msha	Marvel Super Heroes (Asia 951024)
mshh	Marvel Super Heroes (Hispanic 951117)
mshb	Marvel Super Heroes (Brazil 951117)
19xx	19XX: The War Against Destiny (US 951207)
19xxj	19XX: The War Against Destiny (Japan 951225)
19xxjr1	19XX: The War Against Destiny (Japan 951207)
19xxa	19XX: The War Against Destiny (Asia 951207)
19xxh	19XX: The War Against Destiny (Hispanic 951218)
ddsom	Dungeons & Dragons: Shadow over Mystara (Euro 960619)
ddsomr1	Dungeons & Dragons: Shadow over Mystara (Euro 960209)
ddsomu	Dungeons & Dragons: Shadow over Mystara (US 960619)
ddsomur1	Dungeons & Dragons: Shadow over Mystara (US 960209)
ddsomjr1	Dungeons & Dragons: Shadow over Mystara (Japan 960206)
ddsomj	Dungeons & Dragons: Shadow over Mystara (Japan 960619)
ddsoma	Dungeons & Dragons: Shadow over Mystara (Asia 960619)
sfa2	Street Fighter Alpha 2 (US 960306)
sfz2j	Street Fighter Zero 2 (Japan 960227)
sfz2a	Street Fighter Zero 2 (Asia 960227)
sfz2b	Street Fighter Zero 2 (Brazil 960531)
sfz2br1	Street Fighter Zero 2 (Brazil 960304)
spf2t	Super Puzzle Fighter 2 Turbo (US 960620)
spf2xj	Super Puzzle Fighter 2 X (Japan 960531)
qndream	Quiz Nanairo Dreams: Nijiirochou no Kiseki (Japan 960826)
megaman2	Mega Man 2: The Power Fighters (US 960708)
megamn2a	Mega Man 2: The Power Fighters (Asia 960708)
rckman2j	Rockman 2: The Power Fighters (Japan 960708)
sfz2aj	Street Fighter Zero 2 Alpha (Japan 960805)
sfz2ah	Street Fighter Zero 2 Alpha (Hispanic 960813)
sfz2ab	Street Fighter Zero 2 Alpha (Brazil 960813)
sfz2aa	Street Fighter Zero 2 Alpha (Asia 960826)
xmvsf	X-Men Vs. Street Fighter (Euro 960910)
xmvsfu	X-Men Vs. Street Fighter (US 961023)
xmvsfur1	X-Men Vs. Street Fighter (US 961004)
xmvsfj	X-Men Vs. Street Fighter (Japan 961004)
xmvsfjr1	X-Men Vs. Street Fighter (Japan 960910)
xmvsfjr2	X-Men Vs. Street Fighter (Japan 960909)
xmvsfa	X-Men Vs. Street Fighter (Asia 961023)
xmvsfh	X-Men Vs. Street Fighter (Hispanic 961004)
xmvsfb	X-Men Vs. Street Fighter (Brazil 961023)
batcir	Battle Circuit (Euro 970319)
batcirj	Battle Circuit (Japan 970319)
batcira	Battle Circuit (Asia 970319)
vsav	Vampire Savior: The Lord of Vampire (Euro 970519)
vsavu	Vampire Savior: The Lord of Vampire (US 970519)
vsavj	Vampire Savior: The Lord of Vampire (Japan 970519)
vsava	Vampire Savior: The Lord of Vampire (Asia 970519)
vsavh	Vampire Savior: The Lord of Vampire (Hispanic 970519)
mshvsf	Marvel Super Heroes Vs. Street Fighter (US 970827)
mshvsfu1	Marvel Super Heroes Vs. Street Fighter (US 970625)
mshvsfj	Marvel Super Heroes Vs. Street Fighter (Japan 970707)
mshvsfj1	Marvel Super Heroes Vs. Street Fighter (Japan 970702)
mshvsfj2	Marvel Super Heroes Vs. Street Fighter (Japan 970625)
mshvsfh	Marvel Super Heroes Vs. Street Fighter (Hispanic 970625)
mshvsfa	Marvel Super Heroes Vs. Street Fighter (Asia 970625)
mshvsfa1	Marvel Super Heroes Vs. Street Fighter (Asia 970620)
mshvsfb	Marvel Super Heroes Vs. Street Fighter (Brazil 970827)
mshvsfb1	Marvel Super Heroes Vs. Street Fighter (Brazil 970625)
csclub	Capcom Sports Club (Euro 970722)
csclubj	Capcom Sports Club (Japan 970722)
cscluba	Capcom Sports Club (Asia 970722)
csclubh	Capcom Sports Club (Hispanic 970722)
sgemf	Super Gem Fighter Mini Mix (US 970904)
pfghtj	Pocket Fighter (Japan 970904)
sgemfa	Super Gem Fighter: Mini Mix (Asia 970904)
sgemfh	Super Gem Fighter: Mini Mix (Hispanic 970904)
vhunt2r1	Vampire Hunter 2: Darkstalkers Revenge (Japan 970913)
vhunt2	Vampire Hunter 2: Darkstalkers Revenge (Japan 970929)
vsav2	Vampire Savior 2: The Lord of Vampire (Japan 970913)
mvsc	Marvel Vs. Capcom: Clash of Super Heroes (US 980123)
mvscj	Marvel Vs. Capcom: Clash of Super Heroes (Japan 980123)
mvscjr1	Marvel Vs. Capcom: Clash of Super Heroes (Japan 980112)
mvsca	Marvel Vs. Capcom: Clash of Super Heroes (Asia 980112)
mvsch	Marvel Vs. Capcom: Clash of Super Heroes (Hispanic 980123)
sfa3	Street Fighter Alpha 3 (US 980904)
sfa3r1	Street Fighter Alpha 3 (US 980629)
sfz3j	Street Fighter Zero 3 (Japan 980727)
sfz3jr1	Street Fighter Zero 3 (Japan 980629)
sfz3a	Street Fighter Zero 3 (Asia 980701)
gigawing	Giga Wing (US 990222)
gwingj	Giga Wing (Japan 990223)
dimahoo	Dimahoo (US 000121)
gmahou	Great Mahou Daisakusen (Japan 000121)
mmatrix	Mars Matrix: Hyper Solid Shooting (US 000412)
mmatrixj	Mars Matrix: Hyper Solid Shooting (Japan 000412)
1944	1944: The Loop Master (US 000620)
1944j	1944: The Loop Master (Japan 000620)
mpangj	Mighty! Pang (Japan 001011)
ts2	Battle Arena Toshinden 2 (USA 951124)
ts2j	Battle Arena Toshinden 2 (JAPAN 951124)
starglad	Star Gladiator (USA 960627)
sfex	Street Fighter EX (ASIA 961219)
sfexj	Street Fighter EX (JAPAN 961130)
glpracr	Gallop Racer (JAPAN Ver 9.01.12)
sfexp	Street Fighter EX Plus (USA 970311)
sfexpj	Street Fighter EX Plus (JAPAN 970311)
rvschool	Rival Schools (ASIA 971117)
jgakuen	Justice Gakuen (JAPAN 971117)
tgmj	Tetris The Grand Master (JAPAN 980710)
sfex2	Street Fighter EX 2 (JAPAN 980312)
sg2j	Star Gladiator 2 (JAPAN 980316)
techromn	Tech Romancer (USA 980914)
kikaioh	Kikaioh (JAPAN 980914)
sfex2p	Street Fighter EX 2 Plus (JAPAN 990611)
strider2	Strider 2 (USA 991213)
stridr2a	Strider 2 (ASIA 991213)
shiryu2	Strider Hiryu 2 (JAPAN 991213)
glpracr2	Gallop Racer 2 (USA)
glprac2j	Gallop Racer 2 (JAPAN)
glprac2l	Gallop Racer 2 Link HW (JAPAN)
doapp	Dead Or Alive ++ (JAPAN)
tondemo	Tondemo Crisis (JAPAN)
brvblade	Brave Blade (JAPAN)
beastrzr	Beastorizer
primrag2	Primal Rage 2
nbajamex	NBA Jam Extreme
jdredd	Judge Dredd (Rev C)
jdreddb	Judge Dredd (Rev B)
sncwgltd	Sonic Wings Limited (JAPAN)
psyforce	Psychic Force (JAPAN)
sfchamp	Super Football Champ (JAPAN)
mgcldate	Magical Date (JAPAN) set 1
mgcldtea	Magical Date (JAPAN) set 2
raystorm	Ray Storm (JAPAN)
ftimpcta	Fighter's Impact Ace (JAPAN)
gdarius	G-Darius (JAPAN)
gdarius2	G-Darius Ver.2 (JAPAN)
beastrzb	Beastorizer (bootleg)
tekken	Tekken (TE4/VER.C)
tekkena	Tekken (TE2/VER.B)
tekkenb	Tekken (TE1/VER.B)
tekken2	Tekken 2 Ver.B (TES3/VER.B)
tekken2a	Tekken 2 Ver.B (TES2/VER.B)
tekken2b	Tekken 2 (TES2/VER.A)
souledge	Soul Edge Ver. II (SO4/VER.C)
souledga	Soul Edge (SO3/VER.A)
souledgb	Soul Edge (SO1/VER.A)
dunkmnia	Dunk Mania (DM1/VER.C)
xevi3dg	Xevious 3D/G (XV31/VER.A)
primglex	Prime Goal EX (PG1/VER.A)
danceyes	Dancing Eyes (DC1/VER.A)
starswep	Star Sweep (STP1/VER.A)
myangel3	Kosodate Quiz My Angel 3 (KQT1/VER.A)
tekken3	Tekken 3 (TET1/VER.E)
soulclbr	Soul Calibur (SOC1/VER.A)
ehrgeiz	Ehrgeiz (EG3/VER.A)
mdhorse	Derby Quiz My Dream Horse (MDH1/VER.A)
fgtlayer	Fighting Layer (FTL1/VER.A)
pacapp	Paca Paca Passion (PPP1/VERA)
sws99	Super World Stadium '99 (SS91/VER.A)
tekkentt	Tekken Tag Tournament (TEG3/VER.B)
mrdrillr	Mr Driller (DRI1/VER.A)
aquarush	Aqua Rush (AQ1/VER.A)
golgo13	Golgo 13 (GLG1/VER.A)
mrdrilr2	Mr Driller 2
cryptklr	Crypt Killer (ver. UAA)
mgakuen	Mahjong Gakuen
7toitsu	Chi-Toitsu
mgakuen2	Mahjong Gakuen 2 Gakuen-chou no Fukushuu
pkladies	Poker Ladies
pkladiel	Poker Ladies (Leprechaun)
dokaben	Dokaben (Japan)
pang	Pang (World)
pangb	Pang (bootleg)
bbros	Buster Bros. (US)
pompingw	Pomping World (Japan)
cbasebal	Capcom Baseball (Japan)
cworld	Capcom World (Japan)
hatena	Adventure Quiz 2 Hatena Hatena no Dai-Bouken (Japan)
spang	Super Pang (World)
sbbros	Super Buster Bros. (US)
marukin	Super Marukin-Ban
qtono1	Quiz Tonosama no Yabou (Japan)
qsangoku	Quiz Sangokushi (Japan)
block	Block Block (World 911106 Joystick)
blocka	Block Block (World 910910)
blockj	Block Block (Japan 910910)
blockbl	Block Block (bootleg)
capbowl	Capcom Bowling (set 1)
capbowl2	Capcom Bowling (set 2)
clbowl	Coors Light Bowling
bowlrama	Bowl-O-Rama
wfortune	Wheel Of Fortune
wfortuna	Wheel Of Fortune (alternate)
stratab	Strata Bowling (V3)
stratab1	Strata Bowling (V1)
sstrike	Super Strike Bowling
gtg	Golden Tee Golf (Joystick, v3.1)
hstennis	Hot Shots Tennis (V1.1)
hstenn10	Hot Shots Tennis (V1.0)
slikshot	Slick Shot (V2.2)
sliksh17	Slick Shot (V1.7)
dynobop	Dyno Bop
arlingtn	Arlington Horse Racing (v1.21-D)
peggle	Peggle (Joystick, v1.0)
pegglet	Peggle (Trackball, v1.0)
rimrockn	Rim Rockin' Basketball (V2.2)
rimrck20	Rim Rockin' Basketball (V2.0)
rimrck16	Rim Rockin' Basketball (V1.6)
rimrck12	Rim Rockin' Basketball (V1.2)
ninclown	Ninja Clowns (08/27/91)
gtg2	Golden Tee Golf II (Trackball, V2.2)
gtg2t	Golden Tee Golf II (Trackball, V1.1)
gtg2j	Golden Tee Golf II (Joystick, V1.0)
neckneck	Neck-n-Neck (v1.2)
timekill	Time Killers (v1.32)
timek131	Time Killers (v1.31)
hardyard	Hard Yardage (v1.20)
hardyd10	Hard Yardage (v1.00)
bloodstm	Blood Storm (v2.22)
bloods22	Blood Storm (v2.20)
bloods21	Blood Storm (v2.10)
bloods11	Blood Storm (v1.10)
pairs	Pairs (V1.2, 09/30/94)
pairsa	Pairs (09/07/94)
drivedge	Driver's Edge
wcbowl	World Class Bowling (v1.66)
wcbwl165	World Class Bowling (v1.65)
wcbwl161	World Class Bowling (v1.61)
wcbwl12	World Class Bowling (v1.2)
sftm	Street Fighter: The Movie (v1.12)
sftm110	Street Fighter: The Movie (v1.10)
sftm111	Street Fighter: The Movie (v1.11)
sftmj	Street Fighter: The Movie (v1.12N, Japan)
shufshot	Shuffleshot (v1.39)
sshot137	Shuffleshot (v1.37)
cerberus	Cerberus
mayhem	Mayhem 2002
powrplay	Power Play
wseries	World Series: The Season
alleymas	Alley Master
dangerz	Danger Zone
basebal2	Baseball The Season II
dblplay	Super Baseball Double Play Home Run Derby
strkzone	Strike Zone Baseball
redlin2p	Redline Racer (2 players)
quarterb	Quarterback
quartrba	Quarterback (set 2)
viper	Viper
teamqb	John Elway's Team Quarterback
teamqb2	John Elway's Team Quarterback (set 2)
aafb	All American Football (rev E)
aafbd2p	All American Football (rev D, 2 Players)
aafbc	All American Football (rev C)
aafbb	All American Football (rev B)
offroad	Ironman Stewart's Super Off-Road
offroadt	Ironman Stewart's Super Off-Road Track Pack
pigout	Pigout
pigouta	Pigout (alternate)
ataxx	Ataxx (set 1)
ataxxa	Ataxx (set 2)
ataxxj	Ataxx (Japan)
wsf	World Soccer Finals
indyheat	Danny Sullivan's Indy Heat
brutforc	Brute Force
asylum	Asylum (prototype)
blockade	Blockade
comotion	Comotion
hustle	Hustle
blasto	Blasto
mineswpr	Minesweeper
depthch	Depthcharge
depthv1	Depthcharge (older)
subhunt	Sub Hunter
safari	Safari
frogs	Frogs
sspaceat	Space Attack (upright)
sspacat2	Space Attack (upright, older)
sspacatc	Space Attack (cocktail)
sspacaho	Space Attack / Head On
headon	Head On (2 players)
headonb	Head On (1 player)
headon2	Head On 2
invho2	Invinco / Head On 2
samurai	Samurai
invinco	Invinco
invds	Invinco / Deep Scan
tranqgun	Tranquilizer Gun
spacetrk	Space Trek (upright)
sptrekct	Space Trek (cocktail)
carnival	Carnival (upright)
carnvckt	Carnival (cocktail)
brdrlinb	Borderline (bootleg)
digger	Digger
pulsar	Pulsar
heiankyo	Heiankyo Alien
alphaho	Alpha Fighter / Head On
spacfury	Space Fury (revision C)
spacfura	Space Fury (revision A)
zektor	Zektor (revision B)
tacscan	Tac/Scan
elim2	Eliminator (2 Players, set 1)
elim2a	Eliminator (2 Players, set 2)
elim4	Eliminator (4 Players)
startrek	Star Trek
astrob	Astro Blaster (version 3)
astrob2	Astro Blaster (version 2)
astrob1	Astro Blaster (version 1)
005	005
monsterb	Monster Bash
spaceod	Space Odyssey
pignewt	Pig Newton (version C)
pignewta	Pig Newton (version A)
sindbadm	Sindbad Mystery
zaxxon	Zaxxon (set 1)
zaxxon2	Zaxxon (set 2)
zaxxonb	Jackson
szaxxon	Super Zaxxon
futspy	Future Spy
razmataz	Razzmatazz
ixion	Ixion (prototype)
congo	Congo Bongo
tiptop	Tip Top
chboxing	Champion Boxing
chwrestl	Champion Pro Wrestling
starjack	Star Jacker (Sega)
starjacs	Star Jacker (Stern)
regulus	Regulus (New Ver.)
reguluso	Regulus (Old Ver.)
regulusu	Regulus (not encrypted)
upndown	Up'n Down
upndownu	Up'n Down (not encrypted)
mrviking	Mister Viking
mrvikngj	Mister Viking (Japan)
swat	SWAT
flicky	Flicky (128k Ver.)
flickyo	Flicky (64k Ver.)
wmatch	Water Match
bullfgt	Bullfight
thetogyu	The Togyu (Japan)
spatter	Spatter
ssanchan	Sanrin San Chan (Japan)
pitfall2	Pitfall II
pitfallu	Pitfall II (not encrypted)
seganinj	Sega Ninja
seganinu	Sega Ninja (not encrypted)
nprinces	Ninja Princess (64k Ver. bootleg?)
nprincso	Ninja Princess (128k Ver.)
nprincsu	Ninja Princess (64k Ver. not encrypted)
nprincsb	Ninja Princess (128k Ver. bootleg?)
imsorry	I'm Sorry (US)
imsorryj	Gonbee no I'm Sorry (Japan)
teddybb	TeddyBoy Blues (New Ver.)
teddybbo	TeddyBoy Blues (Old Ver.)
hvymetal	Heavy Metal
myhero	My Hero (US)
sscandal	Seishun Scandal (Japan)
myherok	My Hero (Korea)
shtngmst	Shooting Master
chplft	Choplifter
chplftb	Choplifter (alternate)
chplftbl	Choplifter (bootleg)
4dwarrio	4-D Warriors
brain	Brain
raflesia	Rafflesia
wboy	Wonder Boy (set 1, new encryption)
wboyo	Wonder Boy (set 1, old encryption)
wboy2	Wonder Boy (set 2)
wboy2u	Wonder Boy (set 2 not encrypted)
wboy3	Wonder Boy (set 3)
wboyu	Wonder Boy (not encrypted)
wbdeluxe	Wonder Boy Deluxe
gardia	Gardia
gardiab	Gardia (bootleg)
noboranb	Noboranka (Japan)
blockgal	Block Gal
blckgalb	Block Gal (bootleg)
tokisens	Toki no Senshi - Chrono Soldier
wbml	Wonder Boy in Monster Land (Japan New Ver.)
wbmljo	Wonder Boy in Monster Land (Japan Old Ver.)
wbmljb	Wonder Boy in Monster Land (Japan not encrypted)
wbmlb	Wonder Boy in Monster Land
dakkochn	DakkoChan Jansoh
ufosensi	Ufo Senshi Yohko Chan
hangonjr	Hang-On Jr.
transfrm	Transformer
astrofl	Astro Flash (Japan)
ridleofp	Riddle of Pythagoras (Japan)
fantzn2	Fantasy Zone 2
opaopa	Opa Opa
turbo	Turbo
turboa	Turbo (encrypted set 1)
turbob	Turbo (encrypted set 2)
subroc3d	Subroc-3D
buckrog	Buck Rogers: Planet of Zoom
buckrogn	Buck Rogers: Planet of Zoom (not encrypted)
kopunch	KO Punch
suprloco	Super Locomotive
dotrikun	Dottori Kun (new version)
dotriku2	Dottori Kun (old version)
spcpostn	Space Position (Japan)
angelkds	Angel Kids (Japan)
alexkidd	Alex Kidd: The Lost Stars (set 1)
aliensya	Alien Syndrome (set 2)
aliensyb	Alien Syndrome (set 3)
aliensyj	Alien Syndrome (Japan)
astorm	Alien Storm
astorm2p	Alien Storm (2 Player)
auraila	Aurail (set 2)
bayrouta	Bay Route (set 2)
bayrtbl1	Bay Route (bootleg set 1)
bayrtbl2	Bay Route (bootleg set 2)
enduror	Enduro Racer
eswat	E-Swat - Cyber Police
fpoint	Flash Point
goldnaxb	Golden Axe (Version 2 317-0110)
goldnaxc	Golden Axe (Version 2 317-0122)
goldnaxj	Golden Axe (Version 1, Japan)
jyuohki	Jyuohki (Japan)
moonwalk	Michael Jackson's Moonwalker (Set 1)
moonwlka	Michael Jackson's Moonwalker (Set 2)
passsht	Passing Shot (2 Players)
sdioj	SDI - Strategic Defense Initiative (Japan)
shangon	Super Hang-On
shinobia	Shinobi (set 2)
shinobib	Shinobi (set 3)
tetris	Tetris (Sega Set 1)
tetrisa	Tetris (Sega Set 2)
wb3a	Wonder Boy III - Monster Lair (set 2)
aceattac	Ace Attacker
afighter	Action Fighter
bloxeed	Bloxeed
cltchitr	Clutch Hitter
cotton	Cotton (Japan)
cottona	Cotton
ddcrew	DD Crew
dunkshot	Dunk Shot
exctleag	Excite League
lghost	Laser Ghost
loffire	Line of Fire
mvp	MVP
ryukyu	Ryukyu
suprleag	Super League
thndrbld	Thunder Blade
thndrbdj	Thunder Blade (Japan)
toutrun	Turbo Outrun (set 1)
toutruna	Turbo Outrun (set 2)
aburner	After Burner (Japan)
aburner2	After Burner II
alexkida	Alex Kidd: The Lost Stars (set 2)
aliensyn	Alien Syndrome (set 1)
altbeas2	Altered Beast (Version 2)
altbeast	Altered Beast (Version 1)
astormbl	Alien Storm (bootleg)
atomicp	Atomic Point
aurail	Aurail (set 1)
bayroute	Bay Route (set 1)
bodyslam	Body Slam
dduxbl	Dynamite Dux (bootleg)
dumpmtmt	Dump Matsumoto (Japan)
endurob2	Enduro Racer (bootleg set 2)
endurobl	Enduro Racer (bootleg set 1)
eswatbl	E-Swat - Cyber Police (bootleg)
fantzone	Fantasy Zone (Japan New Ver.)
fantzono	Fantasy Zone (Old Ver.)
fpointbl	Flash Point (World, bootleg)
fpointbj	Flash Point (Japan, bootleg)
goldnabl	Golden Axe (bootleg)
goldnaxa	Golden Axe (Version 2)
goldnaxe	Golden Axe (Version 1)
hangon	Hang-On
hwchamp	Heavyweight Champ
mjleague	Major League
moonwlkb	Michael Jackson's Moonwalker (bootleg)
outrun	Out Run (set 1)
outruna	Out Run (set 2)
outrunb	Out Run (set 3)
passht4b	Passing Shot (4 Players) (bootleg)
passshtb	Passing Shot (2 Players) (bootleg)
quartet	Quartet
quartet2	Quartet 2
quartt2j	Quartet 2 (Japan)
quartetj	Quartet (Japan)
riotcity	Riot City
sdi	SDI - Strategic Defense Initiative
shangonb	Super Hang-On (bootleg)
sharrier	Space Harrier
shdancbl	Shadow Dancer (bootleg)
shdancer	Shadow Dancer (US)
shdancrj	Shadow Dancer (Japan)
shinobi	Shinobi (set 1)
shinobl	Shinobi (bootleg)
tetrisbl	Tetris (Sega bootleg)
timscanr	Time Scanner
toryumon	Toryumon
tturf	Tough Turf (Japan)
tturfbl	Tough Turf (bootleg)
tturfu	Tough Turf (US)
wb3	Wonder Boy III - Monster Lair (set 1)
wb3bl	Wonder Boy III - Monster Lair (bootleg)
wrestwar	Wrestle War
hotrod	Hot Rod (turbo 3 player)
bnzabros	Bonanza Bros
dcclub	Dynamic Country Club
mahmajn	Tokoro San no MahMahjan
qgh	Quiz Ghost Hunter
quizmeku	Quiz Mekurumeku Story
qrouka	Quiz Rouka Ni Tattenasai
mahmajn2	Tokoro San no MahMahjan 2
sspirits	Scramble Spirits
sgmast	Super Masters Golf
qsww	Quiz Syukudai wo Wasuremashita
gground	Gain Ground
crkdown	Crackdown
holo	Holosseum
svf	Super Visual Football: European Sega Cup
svs	Super Visual Soccer: Sega Cup (US)
jleague	The J.League 1994 (Japan)
brival	Burning Rival (Japan)
radm	Rad Mobile
radr	Rad Rally
f1en	F1 Exhaust Note
alien3	Alien3: The Gun
sonic	Segasonic the Hedgehog (Japan rev. C)
sonicp	Segasonic the Hedgehog (Japan prototype)
jpark	Jurassic Park
ga2	Golden Axe: The Revenge of Death Adder (US)
ga2j	Golden Axe: The Revenge of Death Adder (Japan)
spidey	Spider-Man: The Videogame (US)
spideyj	Spider-Man: The Videogame (Japan)
arabfgt	Arabian Fight
f1lap	F1 Super Lap
dbzvrvs	Dragon Ball Z V.R.V.S.
darkedge	Dark Edge
slipstrm	Slipstream
orunners	Outrunners (US)
harddunk	Hard Dunk (World)
harddunj	Hard Dunk (Japan)
titlef	Title Fight
scross	Stadium Cross (World)
astrass	Astra SuperStars
bakubaku	Baku Baku Animal
colmns97	Columns 97
cotton2	Cotton 2
cottonbm	Cotton Boomerang
decathlt	Decathlete
diehard	Die Hard Arcade (US)
dnmtdeka	Dynamite Deka (Japan)
ejihon	Ejihon Tantei Jimusyo
elandore	Fighting Dragon Legend Elan Doree
ffreveng	Final Fight Revenge
fhboxers	Funky Head Boxers
findlove	Find Love
finlarch	Final Arch (Japan)
gaxeduel	Golden Axe - The Duel
grdforce	Guardian Force
groovef	Power Instinct 3 - Groove On Fight
hanagumi	Hanagumi Taisen Columns - Sakura Wars
introdon	Karaoke Quiz Intro Don Don!
kiwames	Pro Mahjong Kiwame S
maruchan	Maru-Chan de Goo!
myfairld	Virtual Mahjong 2 - My Fair Lady
othellos	Othello Shiyouyo
pblbeach	Pebble Beach - The Great Shot
prikura	Princess Clara Daisakusen
puyosun	Puyo Puyo Sun
rsgun	Radiant Silvergun
sandor	Sando-R
thunt	Treasure Hunt
sassisu	Taisen Tanto-R Sashissu!!
seabass	Sea Bass Fishing
shanhigw	Shanghai - The Great Wall / Shanghai Triple Threat
shienryu	Shienryu
sleague	Super Major League (US)
sokyugrt	Soukyugurentai / Terra Diver
sss	Steep Slope Sliders
suikoenb	Suikoenbu
twcup98	Tecmo World Cup '98
vfkids	Virtua Fighter Kids
vfremix	Virtua Fighter Remix
vmahjong	Virtual Mahjong
winterht	Winter Heat
znpwfv	Zen Nippon Pro-Wrestling Featuring Virtua
danchih	Danchi de Hanafuda
mausuke	Mausuke no Ojama the World
batmanfr	Batman Forever
sfish2	Sport Fishing 2
sfish2j	Sport Fishing 2 (Japan)
logicpro	Logic Pro (Japan)
croquis	Croquis (Germany)
karianx	Karian Cross (Rev. 1.0)
logicpr2	Logic Pro 2 (Japan)
bloxeedc	Bloxeed (C System)
columns	Columns (US)
columnsj	Columns (Japan)
columns2	Columns II - The Voyage Through Time (Japan)
borench	Borench
tfrceac	ThunderForce AC
tfrceacj	ThunderForce AC (Japan)
tfrceacb	ThunderForce AC (bootleg)
ribbit	Ribbit!
tantr	Tant-R (Puzzle & Action) (Japan)
tantrbl	Tant-R (Puzzle & Action) (Japan) (bootleg set 1)
tantrbl2	Tant-R (Puzzle & Action) (Japan) (bootleg set 2)
puyopuyo	Puyo Puyo (Japan)
puyopuya	Puyo Puyo (Japan) (Rev A)
puyopuyb	Puyo Puyo (English) (bootleg)
ichidant	Ichidant-R (Puzzle & Action 2) (Japan)
ichidnte	Ichidant-R (Puzzle & Action 2) (English)
ichidntb	Ichidant-R (Puzzle & Action 2) (Japan) (bootleg)
stkclmns	Stack Columns (Japan)
puyopuy2	Puyo Puyo 2 (Japan)
potopoto	Poto Poto (Japan)
zunkyou	Zunzunkyou No Yabou (Japan)
pclubj	Print Club (Japan Vol.1)
pclubjv2	Print Club (Japan Vol.2)
pclubjv4	Print Club (Japan Vol.4)
pclubjv5	Print Club (Japan Vol.5)
puckpkmn	Puckman Pockimon
mt_beast	MegaTech: Altered Beast
mt_shar2	MegaTech: Space Harrier 2.
mt_stbld	MegaTech: Super Thunder Blade
mt_ggolf	MegaTech: Great Golf
mt_gsocr	MegaTech: Great Soccer
mt_shnbi	MegaTech: Shinobi
mt_aftrb	MegaTech: Afterburner
mt_tfor2	MegaTech: Thunder Force 2
mt_astro	MegaTech: Astro Warrior
mt_lastb	MegaTech: Last Battle.
mt_wcsoc	MegaTech: World Cup Soccer
mt_tetri	MegaTech: Tetris
mt_gng	MegaTech: Ghouls and Ghosts
mt_gaxe	MegaTech: Golden Axe
mt_mystd	MegaTech: Mystic Defender
mt_revsh	MegaTech: The Revenge Of Shinobi
mt_parlg	MegaTech: Parlour Games
mt_tgolf	MegaTech: Arnold Palmer Tournament Golf
mt_tlbba	MegaTech: Tommy Lasorda Baseball
mt_eswat	MegaTech: E-Swat
mt_smgp	MegaTech: Super Monaco Grand Prix
mt_mwalk	MegaTech: Moonwalker
mt_bbros	MegaTech: Bonanza Bros.
mt_sonic	MegaTech: Sonic the Hedgehog
mt_fshrk	MegaTech: Fire Shark
mt_gaxe2	MegaTech: Golden Axe 2
mt_kcham	MegaTech: Kid Chameleon
mp_sonic	MegaPlay: Sonic The Hedgehog
mp_gaxe2	MegaPlay: Golden Axe 2
lnc	Lock'n'Chase
zoar	Zoar
btime	Burger Time (Data East set 1)
btime2	Burger Time (Data East set 2)
btimem	Burger Time (Midway)
cookrace	Cook Race
wtennis	World Tennis
brubber	Burnin' Rubber
bnj	Bump 'n' Jump
caractn	Car Action
disco	Disco No.1
discof	Disco No.1 (Rev.F)
sdtennis	Super Doubles Tennis
mmonkey	Minky Monkey
ctsttape	Cassette: Test Tape
cterrani	Cassette: Terranean
castfant	Cassette: Astro Fantasia
csuperas	Cassette: Super Astro Fighter
clocknch	Cassette: Lock'n'Chase
cprogolf	Cassette: Pro Golf
cluckypo	Cassette: Lucky Poker
ctisland	Cassette: Treasure Island (set 1)
ctislnd2	Cassette: Treasure Island (set 2)
ctislnd3	Cassette: Treasure Island (set 3)
cdiscon1	Cassette: Disco No.1
csweetht	Cassette: Sweet Heart
ctornado	Cassette: Tornado
cmissnx	Cassette: Mission-X
cptennis	Cassette: Pro Tennis
cexplore	Cassette: Explorer
cbtime	Cassette: Burger Time
cburnrub	Cassette: Burnin' Rubber (set 1)
cburnrb2	Cassette: Burnin' Rubber (set 2)
cbnj	Cassette: Bump N Jump
cgraplop	Cassette: Graplop (aka Cluster Buster) (set 1)
cgraplp2	Cassette: Graplop (aka Cluster Buster) (set 2)
clapapa	Cassette: Rootin' Tootin' (aka La.Pa.Pa)
clapapa2	Cassette: Rootin' Tootin'
cnightst	Cassette: Night Star (set 1)
cnights2	Cassette: Night Star (set 2)
cprosocc	Cassette: Pro Soccer
cprobowl	Cassette: Pro Bowling
cscrtry	Cassette: Scrum Try (set 1)
cscrtry2	Cassette: Scrum Try (set 2)
cppicf	Cassette: Peter Pepper's Ice Cream Factory (set 1)
cppicf2	Cassette: Peter Pepper's Ice Cream Factory (set 2)
cfghtice	Cassette: Fighting Ice Hockey
cbdash	Cassette: Boulder Dash
chwy	Cassette: Highway Chase?
cflyball	Cassette: Flying Ball?
czeroize	Cassette: Zeroize?
astrof	Astro Fighter (set 1)
astrof2	Astro Fighter (set 2)
astrof3	Astro Fighter (set 3)
tomahawk	Tomahawk 777 (Revision 1)
tomahaw5	Tomahawk 777 (Revision 5)
prosoccr	Pro Soccer
prosport	Prosport
boomrang	Boomer Rang'r / Genesis
kamikcab	Kamikaze Cabbie
liberate	Liberation
liberatb	Liberation (bootleg)
bwing	B-Wings (Japan)
bwings	Battle Wings
batwings	Battle Wings (alt)
zaviga	Zaviga
zavigaj	Zaviga (Japan)
kchamp	Karate Champ (US)
karatedo	Karate Dou (Japan)
kchampvs	Karate Champ (US VS version)
karatevs	Taisen Karate Dou (Japan VS version)
compgolf	Competition Golf Final Round (Japan)
tryout	Pro Yakyuu Nyuudan Test Tryout (JPN Ver.)
firetrap	Fire Trap (US)
firetpbl	Fire Trap (Japan bootleg)
metlclsh	Metal Clash (Japan)
brkthru	Break Thru (US)
brkthruj	Kyohkoh-Toppa (Japan)
darwin	Darwin 4078 (Japan)
shootout	Shoot Out (US)
shootouj	Shoot Out (Japan)
shootoub	Shoot Out (Korean Bootleg)
sidepckt	Side Pocket (World)
sidepctj	Side Pocket (Japan)
sidepctb	Side Pocket (bootleg)
exprraid	Express Raider (US)
wexpress	Western Express (World?)
wexpresb	Western Express (bootleg set 1)
wexpresc	Western Express (bootleg set 2)
pcktgal	Pocket Gal (Japan)
pcktgalb	Pocket Gal (bootleg)
pcktgal2	Pocket Gal 2 (World?)
spool3	Super Pool III (World?)
spool3i	Super Pool III (I-Vics)
battlera	Battle Rangers (World)
bldwolf	Bloody Wolf (US)
actfancr	Act-Fancer Cybernetick Hyper Weapon (World revision 2)
actfanc1	Act-Fancer Cybernetick Hyper Weapon (World revision 1)
actfancj	Act-Fancer Cybernetick Hyper Weapon (Japan revision 1)
triothep	Trio The Punch - Never Forget Me... (Japan)
lastmisn	Last Mission (US revision 6)
lastmsno	Last Mission (US revision 5)
lastmsnj	Last Mission (Japan)
shackled	Shackled (US)
breywood	Breywood (Japan revision 2)
csilver	Captain Silver (Japan)
ghostb	The Real Ghostbusters (US 2 Players)
ghostb3	The Real Ghostbusters (US 3 Players)
meikyuh	Meikyuu Hunter G (Japan)
srdarwin	Super Real Darwin (World)
srdarwnj	Super Real Darwin (Japan)
gondo	Gondomania (US)
makyosen	Makyou Senshi (Japan)
garyoret	Garyo Retsuden (Japan)
cobracom	Cobra-Command (World revision 5)
cobracmj	Cobra-Command (Japan)
oscar	Psycho-Nics Oscar (US)
oscarj	Psycho-Nics Oscar (Japan revision 2)
oscarj1	Psycho-Nics Oscar (Japan revision 1)
oscarj0	Psycho-Nics Oscar (Japan revision 0)
karnov	Karnov (US)
karnovj	Karnov (Japan)
wndrplnt	Wonder Planet (Japan)
chelnov	Chelnov - Atomic Runner (World)
chelnovu	Chelnov - Atomic Runner (US)
chelnovj	Chelnov - Atomic Runner (Japan)
hbarrel	Heavy Barrel (US)
hbarrelw	Heavy Barrel (World)
baddudes	Bad Dudes vs. Dragonninja (US)
drgninja	Dragonninja (Japan)
birdtry	Birdie Try (Japan)
robocop	Robocop (World revision 4)
robocopw	Robocop (World revision 3)
robocopj	Robocop (Japan)
robocopu	Robocop (US revision 1)
robocpu0	Robocop (US revision 0)
robocopb	Robocop (World bootleg)
hippodrm	Hippodrome (US)
ffantasy	Fighting Fantasy (Japan revision 2)
ffantasa	Fighting Fantasy (Japan)
slyspy	Sly Spy (US revision 3)
slyspy2	Sly Spy (US revision 2)
secretag	Secret Agent (World)
secretab	Secret Agent (bootleg)
midres	Midnight Resistance (World)
midresu	Midnight Resistance (US)
midresj	Midnight Resistance (Japan)
bouldash	Boulder Dash / Boulder Dash Part 2 (World)
bouldshj	Boulder Dash / Boulder Dash Part 2 (Japan)
stadhero	Stadium Hero (Japan)
madmotor	Mad Motor
vaportra	Vapor Trail - Hyper Offence Formation (World revision 1)
vaportru	Vapor Trail - Hyper Offence Formation (US)
kuhga	Kuhga - Operation Code 'Vapor Trail' (Japan revision 3)
cbuster	Crude Buster (World FX version)
cbusterw	Crude Buster (World FU version)
cbusterj	Crude Buster (Japan)
twocrude	Two Crude (US)
darkseal	Dark Seal (World revision 3)
darksea1	Dark Seal (World revision 1)
darkseaj	Dark Seal (Japan)
gatedoom	Gate of Doom (US revision 4)
gatedom1	Gate of Doom (US revision 1)
edrandy	The Cliffhanger - Edward Randy (World revision 2)
edrandy1	The Cliffhanger - Edward Randy (World revision 1)
edrandyj	The Cliffhanger - Edward Randy (Japan)
supbtime	Super Burger Time (World)
supbtimj	Super Burger Time (Japan)
mutantf	Mutant Fighter (World Rev 4, EM-5)
mutantfa	Mutant Fighter (World Rev 3, EM-4)
deathbrd	Death Brade (Japan Rev 2, JM-3)
cninja	Caveman Ninja (World revision 3)
cninja0	Caveman Ninja (World revision 0)
cninjau	Caveman Ninja (US)
joemac	Tatakae Genshizin Joe & Mac (Japan)
stoneage	Stoneage
robocop2	Robocop 2 (World)
robocp2u	Robocop 2 (US)
robocp2j	Robocop 2 (Japan)
thndzone	Thunder Zone (World)
dassault	Desert Assault (US)
dassaul4	Desert Assault (US 4 Players)
chinatwn	China Town (Japan)
rohga	Rohga Armour Force (Asia/Europe v3.0)
rohgah	Rohga Armour Force (Hong Kong v3.0)
rohgau	Rohga Armour Force (US v1.0)
captaven	Captain America and The Avengers (Asia Rev 1.9)
captavna	Captain America and The Avengers (Asia Rev 1.0)
captavne	Captain America and The Avengers (UK Rev 1.4)
captavnu	Captain America and The Avengers (US Rev 1.9)
captavuu	Captain America and The Avengers (US Rev 1.6)
captavnj	Captain America and The Avengers (Japan Rev 0.2)
tumblep	Tumble Pop (World)
tumblepj	Tumble Pop (Japan)
tumblepb	Tumble Pop (bootleg set 1)
tumblep2	Tumble Pop (bootleg set 2)
jumpkids	Jump Kids
fncywld	Fancy World - Earth of Crisis
htchctch	Hatch Catch
bcstry	BC Story
lemmings	Lemmings (US Prototype)
dragngun	Dragon Gun (US)
wizdfire	Wizard Fire (US v1.1)
darksel2	Dark Seal 2 (Japan v2.1)
funkyjet	Funky Jet
nitrobal	Nitro Ball (US)
fghthist	Fighter's History (US)
fghthstw	Fighter's History (World)
fghthsta	Fighter's History (US Alternate Hardware)
nslasher	Night Slashers
lockload	Locked 'n Loaded (US)
tattass	Tattoo Assassins (US Prototype)
tattassa	Tattoo Assassins (Asia Prototype)
avengrgs	Avengers In Galactic Storm (Japan)
sotsugyo	Sotsugyo Shousho
sshangha	Super Shanghai Dragon's Eye (Japan)
sshanghb	Super Shanghai Dragon's Eye (World, bootleg)
senjyo	Senjyo
starforc	Star Force
starfore	Star Force (encrypted)
megaforc	Mega Force
baluba	Baluba-louk no Densetsu
bombjack	Bomb Jack (set 1)
bombjac2	Bomb Jack (set 2)
pbaction	Pinball Action (set 1)
pbactio2	Pinball Action (set 2)
tehkanwc	Tehkan World Cup
gridiron	Gridiron Fight
teedoff	Tee'd Off (Japan)
solomon	Solomon's Key (Japan)
rygar	Rygar (US set 1)
rygar2	Rygar (US set 2)
rygarj	Argus no Senshi (Japan)
gemini	Gemini Wing
silkworm	Silk Worm (set 1)
silkwrm2	Silk Worm (set 2)
tbowl	Tecmo Bowl (World?)
tbowlj	Tecmo Bowl (Japan)
shadoww	Shadow Warriors (World set 1)
shadowwa	Shadow Warriors (World set 2)
gaiden	Ninja Gaiden (US)
ryukendn	Ninja Ryukenden (Japan)
wildfang	Wild Fang / Tecmo Knight
tknight	Tecmo Knight
stratof	Raiga - Strato Fighter (US)
raiga	Raiga - Strato Fighter (Japan)
wc90	Tecmo World Cup '90 (set 1)
wc90a	Tecmo World Cup '90 (set 2)
wc90t	Tecmo World Cup '90 (trackball)
wc90b	Euro League
spbactn	Super Pinball Action (US)
spbactnj	Super Pinball Action (Japan)
fstarfrc	Final Star Force (US)
ginkun	Ganbare Ginkun
deroon	Deroon DeroDero
tkdensho	Touki Denshou -Angel Eyes-
tutankhm	Tutankham
tutankst	Tutankham (Stern)
junofrst	Juno First
junofstg	Juno First (Gottlieb)
pooyan	Pooyan
pooyans	Pooyan (Stern)
pootan	Pootan
timeplt	Time Pilot
timepltc	Time Pilot (Centuri)
spaceplt	Space Pilot
psurge	Power Surge
megazone	Mega Zone
megaznik	Mega Zone (Kosuka)
pandoras	Pandora's Palace
gyruss	Gyruss (Konami)
gyrussce	Gyruss (Centuri)
venus	Venus
trackfld	Track & Field
trackflc	Track & Field (Centuri)
hyprolym	Hyper Olympic
hyprolyb	Hyper Olympic (bootleg)
whizquiz	Whiz Quiz
mastkin	The Masters of Kin
rocnrope	Roc'n Rope
rocnropk	Roc'n Rope (Kosuka)
circusc	Circus Charlie
circusc2	Circus Charlie (no level select)
circuscc	Circus Charlie (Centuri)
circusce	Circus Charlie (Centuri, earlier)
tp84	Time Pilot '84 (set 1)
tp84a	Time Pilot '84 (set 2)
hyperspt	Hyper Sports
hpolym84	Hyper Olympic '84
sbasketb	Super Basketball (version G)
sbasketo	Super Basketball (version E)
sbasketu	Super Basketball (not encrypted)
mikie	Mikie
mikiej	Shinnyuushain Tooru-kun
mikiehs	Mikie (High School Graffiti)
roadf	Road Fighter (set 1)
roadf2	Road Fighter (set 2)
yiear	Yie Ar Kung-Fu (set 1)
yiear2	Yie Ar Kung-Fu (set 2)
kicker	Kicker
shaolins	Shao-Lin's Road
pingpong	Ping Pong
gberet	Green Beret
rushatck	Rush'n Attack
gberetb	Green Beret (bootleg)
mrgoemon	Mr. Goemon (Japan)
jailbrek	Jail Break
manhatan	Manhattan 24 Bunsyo (Japan)
finalizr	Finalizer - Super Transformation
finalizb	Finalizer - Super Transformation (bootleg)
ironhors	Iron Horse
dairesya	Dai Ressya Goutou (Japan)
farwest	Far West
jackal	Jackal (World)
topgunr	Top Gunner (US)
jackalj	Tokushu Butai Jackal (Japan)
topgunbl	Top Gunner (bootleg)
ddribble	Double Dribble
contra	Contra (US)
contrab	Contra (US bootleg)
contraj	Contra (Japan)
contrajb	Contra (Japan bootleg)
gryzor	Gryzor
combasc	Combat School (joystick)
combasct	Combat School (trackball)
combascj	Combat School (Japan trackball)
bootcamp	Boot Camp
combascb	Combat School (bootleg)
rockrage	Rock 'n Rage (World?)
rockragj	Koi no Hotrock (Japan)
mx5000	MX5000
flkatck	Flak Attack (Japan)
fastlane	Fast Lane
tricktrp	Trick Trap (World?)
labyrunr	Labyrinth Runner (Japan)
labyrunk	Labyrinth Runner (World Ver. K)
thehustl	The Hustler (Japan version M)
thehustj	The Hustler (Japan version J)
rackemup	Rack 'em Up
battlnts	Battlantis
battlntj	Battlantis (Japan)
bladestl	Blades of Steel (version T)
bladstle	Blades of Steel (version E)
hcastle	Haunted Castle (version M)
hcastleo	Haunted Castle (version K)
hcastlej	Akuma-Jou Dracula (Japan version P)
hcastljo	Akuma-Jou Dracula (Japan version N)
ajax	Ajax
typhoon	Typhoon
ajaxj	Ajax (Japan)
scontra	Super Contra
scontraj	Super Contra (Japan)
thunderx	Thunder Cross
thnderxj	Thunder Cross (Japan)
mainevt	The Main Event (4 Players ver. Y)
mainevto	The Main Event (4 Players ver. F)
mainev2p	The Main Event (2 Players ver. X)
ringohja	Ring no Ohja (Japan 2 Players ver. N)
devstors	Devastators (ver. Z)
devstor2	Devastators (ver. X)
devstor3	Devastators (ver. V)
garuka	Garuka (Japan ver. W)
88games	'88 Games
konami88	Konami '88
hypsptsp	Hyper Sports Special (Japan)
gbusters	Gang Busters
crazycop	Crazy Cop (Japan)
crimfght	Crime Fighters (US 4 players)
crimfgt2	Crime Fighters (World 2 Players)
crimfgtj	Crime Fighters (Japan 2 Players)
spy	S.P.Y. - Special Project Y (World ver. N)
spyu	S.P.Y. - Special Project Y (US ver. M)
bottom9	Bottom of the Ninth (version T)
bottom9n	Bottom of the Ninth (version N)
mstadium	Main Stadium (Japan)
blockhl	Block Hole
quarth	Quarth (Japan)
aliens	Aliens (World set 1)
aliens2	Aliens (World set 2)
aliensu	Aliens (US)
aliensj	Aliens (Japan)
surpratk	Surprise Attack (Japan ver. M)
parodius	Parodius DA! (World)
parodisj	Parodius DA! (Japan)
rollerg	Rollergames (US)
rollergj	Rollergames (Japan)
simpsons	The Simpsons (4 Players)
simpsn2p	The Simpsons (2 Players)
simps2pa	The Simpsons (2 Players alt)
simps2pj	The Simpsons (2 Players Japan)
esckids	Escape Kids (Japan 2 Players)
vendetta	Vendetta (World 4 Players ver. T)
vendetao	Vendetta (World 4 Players ver. R)
vendet2p	Vendetta (World 2 Players ver. W)
vendetas	Vendetta (Asia 2 Players ver. U)
vendtaso	Vendetta (Asia 2 Players ver. D)
vendettj	Crime Fighters 2 (Japan 2 Players ver. P)
mogura	Mogura Desse
wecleman	WEC Le Mans 24
hotchase	Hot Chase
chqflag	Chequered Flag
chqflagj	Chequered Flag (Japan)
ultraman	Ultraman (Japan)
hexion	Hexion (Japan)
nemesis	Nemesis
nemesuk	Nemesis (World?)
konamigt	Konami GT
salamand	Salamander (version D)
salamanj	Salamander (version J)
lifefrce	Lifeforce (US)
lifefrcj	Lifeforce (Japan)
blkpnthr	Black Panther
citybomb	City Bomber (World)
citybmrj	City Bomber (Japan)
kittenk	Kitten Kaboodle
nyanpani	Nyan Nyan Panic (Japan)
rf2	Konami RF2 - Red Fighter
twinbee	TwinBee
gradius	Gradius
gwarrior	Galactic Warriors
devilw	Devil World
darkadv	Dark Adventure
majuu	Majuu no Ohkoku
vulcan	Vulcan Venture
gradius2	Gradius II - GOFER no Yabou (Japan New Ver.)
grdius2a	Gradius II - GOFER no Yabou (Japan Old Ver.)
grdius2b	Gradius II - GOFER no Yabou (Japan Older Ver.)
cuebrick	Cue Brick (Japan)
fround	The Final Round (version M)
froundl	The Final Round (version L)
hpuncher	Hard Puncher (Japan)
miaj	M.I.A. - Missing in Action (Japan)
cuebrckj	Cue Brick (World version D)
mia	M.I.A. - Missing in Action (version T)
mia2	M.I.A. - Missing in Action (version S)
tmnt	Teenage Mutant Ninja Turtles (World 4 Players)
tmntu	Teenage Mutant Ninja Turtles (US 4 Players)
tmht	Teenage Mutant Hero Turtles (UK 4 Players)
tmntj	Teenage Mutant Ninja Turtles (Japan 4 Players)
tmht2p	Teenage Mutant Hero Turtles (UK 2 Players)
tmnt2pj	Teenage Mutant Ninja Turtles (Japan 2 Players)
tmnt2po	Teenage Mutant Ninja Turtles (Oceania 2 Players)
punkshot	Punk Shot (US 4 Players)
punksht2	Punk Shot (US 2 Players)
punkshtj	Punk Shot (Japan 2 Players)
lgtnfght	Lightning Fighters (US)
trigon	Trigon (Japan)
blswhstl	Bells & Whistles (Version L)
detatwin	Detana!! Twin Bee (Japan ver. J)
glfgreat	Golfing Greats
glfgretj	Golfing Greats (Japan)
tmnt2	Teenage Mutant Ninja Turtles - Turtles in Time (US 4 Players ver. UAA)
tmnt22p	Teenage Mutant Ninja Turtles - Turtles in Time (US 2 Players ver. UDA)
tmnt2a	Teenage Mutant Ninja Turtles - Turtles in Time (Asia 4 Players ver. ADA)
ssriders	Sunset Riders (World 4 Players ver. EAC)
ssrdrebd	Sunset Riders (World 2 Players ver. EBD)
ssrdrebc	Sunset Riders (World 2 Players ver. EBC)
ssrdruda	Sunset Riders (US 4 Players ver. UDA)
ssrdruac	Sunset Riders (US 4 Players ver. UAC)
ssrdrubc	Sunset Riders (US 2 Players ver. UBC)
ssrdrabd	Sunset Riders (Asia 2 Players ver. ABD)
ssrdrjbd	Sunset Riders (Japan 2 Players ver. JBD)
sunsetbl	Sunset Riders (bootleg 4 Players ver. ADD)
xmen	X-Men (US 4 Players)
xmen2p	X-Men (World 2 Players)
xmen2pj	X-Men (Japan 2 Players)
xmen6p	X-Men (US 6 Players)
xexex	Xexex (World)
xexexj	Xexex (Japan)
asterix	Asterix (World ver. EAD)
astrxeac	Asterix (World ver. EAC)
astrxeaa	Asterix (World ver. EAA)
gijoe	GI Joe (World)
gijoeu	GI Joe (US)
gijoej	GI Joe (Japan)
thndrx2	Thunder Cross II (Japan)
thndrx2a	Thunder Cross II (Asia)
prmrsocr	Premier Soccer (Europe ver. EAB)
prmrsocj	Premier Soccer (Japan ver. JAB)
qgakumon	Quiz Gakumon no Susume (Japan ver. JA2 Type L)
moo	Wild West C.O.W.-Boys of Moo Mesa (World version EA)
mooua	Wild West C.O.W.-Boys of Moo Mesa (US version UA)
moobl	Wild West C.O.W.-Boys of Moo Mesa (bootleg version AA)
bucky	Bucky O'Hare (World version EA)
buckyua	Bucky O'Hare (US version UA)
gaiapols	Gaiapolis (Japan ver JAF)
mystwarr	Mystic Warriors (Europe ver EAA)
mystwaru	Mystic Warriors (US ver UAA)
viostorm	Violent Storm (Europe ver EAB)
viostrmu	Violent Storm (US ver UAB)
viostrmj	Violent Storm (Japan ver JAC)
viostrma	Violent Storm (Asia ver AAC)
dadandrn	Kyukyoku Sentai Dadandarn (Japan ver JAA)
metamrph	Metamorphic Force (US ver UAA)
metamrpj	Metamorphic Force (Japan ver JAA)
mtlchamp	Martial Champion (Europe ver EAA)
mtlchmpj	Martial Champion (Japan ver JAA)
rungun	Run and Gun (World ver. EAA)
rungunu	Run and Gun (US ver. UAB)
slmdunkj	Slam Dunk (Japan ver. JAA))
dbz	Dragonball Z
dbz2	Dragonball Z 2 Super Battle
bishi	Bishi Bashi Championship Mini Game Senshuken
overdriv	Over Drive
gradius3	Gradius III (Japan)
grdius3a	Gradius III (Asia)
grdius3e	Gradius III (World ?)
plygonet	Polygonet Commanders (ver UAA)
racinfrc	Racin' Force (ver UAB)
opengolf	Konami's Open Golf Championship (ver EAD)
ggreats2	Golfing Greats 2 (ver JAC)
le2	Lethal Enforcers II: Gun Fighters (ver EAA)
le2u	Lethal Enforcers II: Gun Fighters (ver UAA)
puzldama	Taisen Puzzle-dama (ver JAA)
gokuparo	Gokujyou Parodius (ver JAD)
fantjour	Fantastic Journey
dragoonj	Dragoon Might (ver JAA)
tbyahhoo	Twin Bee Yahhoo! (ver JAA)
tkmmpzdm	Tokimeki Memorial Taisen Puzzle-dama (ver JAB)
salmndr2	Salamander 2 (ver JAA)
sexyparo	Sexy Parodius (ver JAA)
daiskiss	Daisu-Kiss (ver JAA)
tokkae	Taisen Tokkae-dama (ver JAA)
winspike	Winning Spike (ver JAA)
soccerss	Soccer Superstars (ver JAA)
vsnetscr	Versus Net Soccer (ver UAB)
rungun2	Run and Gun 2 (ver UAA)
slamdnk2	Slam Dunk 2 (ver JAA)
rushhero	Rushing Heroes (ver UAB)
bm1stmix	beatmania (ver JA-B)
bm2ndmix	beatmania 2nd MIX (ver JA-B)
bm2ndmxa	beatmania 2nd MIX (ver JA-A)
bmcompmx	beatmania complete MIX (ver JA-B)
hmcompmx	hiphopmania complete MIX (ver UA-B)
bm4thmix	beatmania 4th MIX (ver JA-A)
hmcompm2	hiphopmania complete MIX 2 (ver UA-A)
bmdct	beatmania f. Dreams Come True (ver JA-A)
bmcorerm	beatmania CORE REMIX (ver JA-A)
carpolo	Car Polo
sidetrac	Side Track
targ	Targ
targc	Targ (cocktail?)
spectar	Spectar (revision 3)
spectar1	Spectar (revision 1?)
rallys	Rallys (bootleg?)
phantoma	Phantomas
venture	Venture (version 5 set 1)
venture2	Venture (version 5 set 2)
venture4	Venture (version 4)
mtrap	Mouse Trap (version 5)
mtrap3	Mouse Trap (version 3)
mtrap4	Mouse Trap (version 4)
pepper2	Pepper II
hardhat	Hard Hat
fax	Fax
circus	Circus
robotbwl	Robot Bowl
crash	Crash
ripcord	Rip Cord
starfire	Star Fire (set 1)
starfira	Star Fire (set 2)
fireone	Fire One
victory	Victory
victorba	Victor Banana
crossbow	Crossbow (version 2.0)
cheyenne	Cheyenne (version 1.0)
combat	Combat (version 3.0)
catch22	Catch-22 (version 8.0)
cracksht	Crackshot (version 2.0)
claypign	Clay Pigeon (version 2.0)
chiller	Chiller (version 3.0)
topsecex	Top Secret (Exidy) (version 1.0)
hitnmiss	Hit 'n Miss (version 3.0)
hitnmis2	Hit 'n Miss (version 2.0)
whodunit	Who Dunit (version 8.0)
showdown	Showdown (version 5.0)
copsnrob	Cops'n Robbers
flyball	Flyball
sprint2	Sprint 2 (set 1)
sprint2a	Sprint 2 (set 2)
sprint4	Sprint 4 (set 1)
sprint4a	Sprint 4 (set 2)
nitedrvr	Night Driver
dominos	Dominos
triplhnt	Triple Hunt
sprint8	Sprint 8
sprint8a	Sprint 8 (play tag & chase)
dragrace	Drag Race
poolshrk	Poolshark
starshp1	Starship 1
starshpp	Starship 1 (prototype?)
superbug	Super Bug
canyon	Canyon Bomber
canyonp	Canyon Bomber (prototype)
destroyr	Destroyer
sprint1	Sprint 1
ultratnk	Ultra Tank
skyraid	Sky Raider
tourtabl	Tournament Table (set 1)
tourtab2	Tournament Table (set 2)
avalnche	Avalanche
firetrk	Fire Truck
skydiver	Sky Diver
sbrkout	Super Breakout
atarifb	Atari Football (revision 2)
atarifb1	Atari Football (revision 1)
orbit	Orbit
boxer	Boxer (prototype)
wolfpack	Wolf Pack (prototype)
videopin	Video Pinball
atarifb4	Atari Football (4 players)
subs	Subs
bsktball	Basketball
abaseb	Atari Baseball (set 1)
abaseb2	Atari Baseball (set 2)
montecar	Monte Carlo
soccer	Atari Soccer
missile	Missile Command (set 1)
missile2	Missile Command (set 2)
suprmatk	Super Missile Attack
llander	Lunar Lander (rev 2)
llander1	Lunar Lander (rev 1)
asteroid	Asteroids (rev 2)
asteroi1	Asteroids (rev 1)
asteroib	Asteroids (bootleg on Lunar Lander hardware)
asterock	Asterock
astdelux	Asteroids Deluxe (rev 2)
astdelu1	Asteroids Deluxe (rev 1)
bzone	Battle Zone (set 1)
bzone2	Battle Zone (set 2)
bzonec	Battle Zone (cocktail)
bradley	Bradley Trainer
redbaron	Red Baron
tempest	Tempest (rev 3)
tempest1	Tempest (rev 1)
tempest2	Tempest (rev 2)
tempest3	Tempest (rev ?)
temptube	Tempest Tubes
spacduel	Space Duel
gravitar	Gravitar (version 3)
gravitr2	Gravitar (version 2)
gravp	Gravitar (prototype)
lunarbat	Lunar Battle (prototype, later)
lunarba1	Lunar Battle (prototype, earlier)
quantum	Quantum (rev 2)
quantum1	Quantum (rev 1)
quantump	Quantum (prototype)
bwidow	Black Widow
starwars	Star Wars (rev 2)
starwar1	Star Wars (rev 1)
mhavoc	Major Havoc (rev 3)
mhavoc2	Major Havoc (rev 2)
mhavocp	Major Havoc (prototype)
mhavocrv	Major Havoc (Return to Vax)
alphaone	Alpha One (prototype, 3 lives)
alphaona	Alpha One (prototype, 5 lives)
esb	The Empire Strikes Back
warlords	Warlords
centiped	Centipede (revision 3)
centipd2	Centipede (revision 2)
centtime	Centipede (1 player, timed)
centipdb	Centipede (bootleg set 1)
centipb2	Centipede (bootleg set 2)
millpac	Millpac
magworm	Magic Worm (bootleg)
milliped	Millipede
qwak	Qwak (prototype)
runaway	Runaway (prototype)
tunhunt	Tunnel Hunt
tunhuntc	Tunnel Hunt (Centuri)
liberatr	Liberator (set 1)
liberat2	Liberator (set 2)
foodf	Food Fight (rev 3)
foodf2	Food Fight (rev 2)
foodfc	Food Fight (cocktail)
ccastles	Crystal Castles (version 4)
ccastle3	Crystal Castles (version 3)
ccastle2	Crystal Castles (version 2)
cloak	Cloak & Dagger (rev 5)
cloaksp	Cloak & Dagger (Spanish)
cloakfr	Cloak & Dagger (French)
cloakgr	Cloak & Dagger (German)
cloud9	Cloud 9 (prototype)
jedi	Return of the Jedi
peterpak	Peter Pack-Rat
marble	Marble Madness (set 1)
marble2	Marble Madness (set 2)
marble3	Marble Madness (set 3)
marble4	Marble Madness (set 4)
indytemp	Indiana Jones and the Temple of Doom (set 1)
indytem2	Indiana Jones and the Temple of Doom (set 2)
indytem3	Indiana Jones and the Temple of Doom (set 3)
indytem4	Indiana Jones and the Temple of Doom (set 4)
indytemd	Indiana Jones and the Temple of Doom (German)
roadrunn	Road Runner (rev 2)
roadrun2	Road Runner (rev 1+)
roadrun1	Road Runner (rev 1)
roadblst	Road Blasters (upright, rev 4)
roadblsg	Road Blasters (upright, German, rev 3)
roadbls3	Road Blasters (upright, rev 3)
roadblg2	Road Blasters (upright, German, rev 2)
roadbls2	Road Blasters (upright, rev 2)
roadblg1	Road Blasters (upright, German, rev 1)
roadbls1	Road Blasters (upright, rev 1)
roadblsc	Road Blasters (cockpit, rev 2)
roadblcg	Road Blasters (cockpit, German, rev 1)
roadblc1	Road Blasters (cockpit, rev 1)
paperboy	Paperboy (rev 3)
paperbr2	Paperboy (rev 2)
paperbr1	Paperboy (rev 1)
ssprint	Super Sprint (rev 4)
ssprint3	Super Sprint (rev 3)
ssprint1	Super Sprint (rev 1)
ssprintg	Super Sprint (German, rev 2)
sspring1	Super Sprint (German, rev 1)
ssprintf	Super Sprint (French)
ssprints	Super Sprint (Spanish)
csprint	Championship Sprint (rev 3)
csprint2	Championship Sprint (rev 2)
csprint1	Championship Sprint (rev 1)
csprintg	Championship Sprint (German, rev 2)
cspring1	Championship Sprint (German, rev 1)
csprintf	Championship Sprint (French)
csprints	Championship Sprint (Spanish, rev 2)
csprins1	Championship Sprint (Spanish, rev 1)
720	720 Degrees (rev 4)
720r3	720 Degrees (rev 3)
720r2	720 Degrees (rev 2)
720r1	720 Degrees (rev 1)
720g	720 Degrees (German, rev 2)
720gr1	720 Degrees (German, rev 1)
apb	APB - All Points Bulletin (rev 7)
apb6	APB - All Points Bulletin (rev 6)
apb5	APB - All Points Bulletin (rev 5)
apb4	APB - All Points Bulletin (rev 4)
apb3	APB - All Points Bulletin (rev 3)
apb2	APB - All Points Bulletin (rev 2)
apb1	APB - All Points Bulletin (rev 1)
apbg	APB - All Points Bulletin (German)
apbf	APB - All Points Bulletin (French)
irobot	I, Robot
harddriv	Hard Drivin' (cockpit, rev 7)
harddrvb	Hard Drivin' (cockpit, British, rev 7)
harddrvg	Hard Drivin' (cockpit, German, rev 7)
harddrvj	Hard Drivin' (cockpit, Japan, rev 7)
harddrb6	Hard Drivin' (cockpit, British, rev 6)
harddrj6	Hard Drivin' (cockpit, Japan, rev 6)
harddrb5	Hard Drivin' (cockpit, British, rev 5)
harddrg4	Hard Drivin' (cockpit, German, rev 4)
harddrv3	Hard Drivin' (cockpit, rev 3)
harddrv2	Hard Drivin' (cockpit, rev 2)
harddrv1	Hard Drivin' (cockpit, rev 1)
harddrvc	Hard Drivin' (compact, rev 2)
harddrcg	Hard Drivin' (compact, German, rev 2)
harddrcb	Hard Drivin' (compact, British, rev 2)
harddrc1	Hard Drivin' (compact, rev 1)
stunrun	S.T.U.N. Runner (rev 6)
stunrunj	S.T.U.N. Runner (rev 7, Japan)
stunrun5	S.T.U.N. Runner (rev 5)
stunrune	S.T.U.N. Runner (rev 5, Europe)
stunrun4	S.T.U.N. Runner (rev 4)
stunrun3	S.T.U.N. Runner (rev 3)
stunrn3e	S.T.U.N. Runner (rev 3, Europe)
stunrun2	S.T.U.N. Runner (rev 2)
stunrn2e	S.T.U.N. Runner (rev 2, Europe)
stunrun0	S.T.U.N. Runner (rev 0)
stunrunp	S.T.U.N. Runner (upright prototype)
racedriv	Race Drivin' (cockpit, rev 5)
racedrvb	Race Drivin' (cockpit, British, rev 5)
racedrvg	Race Drivin' (cockpit, German, rev 5)
racedrv4	Race Drivin' (cockpit, rev 4)
racedrb4	Race Drivin' (cockpit, British, rev 4)
racedrg4	Race Drivin' (cockpit, German, rev 4)
racedrv3	Race Drivin' (cockpit, rev 3)
racedrv2	Race Drivin' (cockpit, rev 2)
racedrv1	Race Drivin' (cockpit, rev 1)
racedrb1	Race Drivin' (cockpit, British, rev 1)
racedrg1	Race Drivin' (cockpit, German, rev 2)
racedrvc	Race Drivin' (compact, rev 5)
racedrcb	Race Drivin' (compact, British, rev 5)
racedrcg	Race Drivin' (compact, German, rev 5)
racedrc4	Race Drivin' (compact, rev 4)
racedcb4	Race Drivin' (compact, British, rev 4)
racedcg4	Race Drivin' (compact, German, rev 4)
racedrc2	Race Drivin' (compact, rev 2)
racedrc1	Race Drivin' (compact, rev 1)
steeltal	Steel Talons (rev 2)
steeltag	Steel Talons (German, rev 2)
steelta1	Steel Talons (rev 1)
steeltap	Steel Talons (prototype)
hdrivair	Hard Drivin's Airborne (prototype)
hdrivaip	Hard Drivin's Airborne (prototype, early rev)
gauntlet	Gauntlet (rev 14)
gaunts	Gauntlet (Spanish, rev 15)
gauntj	Gauntlet (Japanese, rev 13)
gauntg	Gauntlet (German, rev 10)
gauntj12	Gauntlet (Japanese, rev 12)
gauntr9	Gauntlet (rev 9)
gauntgr8	Gauntlet (German, rev 8)
gauntr7	Gauntlet (rev 7)
gauntgr6	Gauntlet (German, rev 6)
gauntr5	Gauntlet (rev 5)
gauntr4	Gauntlet (rev 4)
gauntgr3	Gauntlet (German, rev 3)
gauntr2	Gauntlet (rev 2)
gauntr1	Gauntlet (rev 1)
gaunt2p	Gauntlet (2 Players, rev 6)
gaunt2pj	Gauntlet (2 Players, Japanese, rev 5)
gaunt2pg	Gauntlet (2 Players, German, rev 4)
gaun2pr3	Gauntlet (2 Players, rev 3)
gaun2pj2	Gauntlet (2 Players, Japanese, rev 2)
gaun2pg1	Gauntlet (2 Players, German, rev 1)
gaunt2	Gauntlet II
gaunt2g	Gauntlet II (German)
gaunt22p	Gauntlet II (2 Players, rev 2)
gaun22p1	Gauntlet II (2 Players, rev 1)
gaun22pg	Gauntlet II (2 Players, German)
vindctr2	Vindicators Part II (rev 3)
vindc2r2	Vindicators Part II (rev 2)
vindc2r1	Vindicators Part II (rev 1)
xybots	Xybots (rev 2)
xybotsg	Xybots (German, rev 3)
xybotsf	Xybots (French, rev 3)
xybots1	Xybots (rev 1)
xybots0	Xybots (rev 0)
blstroid	Blasteroids (rev 4)
blstroi3	Blasteroids (rev 3)
blstroi2	Blasteroids (rev 2)
blstroig	Blasteroids (German, rev 2)
blsthead	Blasteroids (with heads)
vindictr	Vindicators (rev 5)
vindicte	Vindicators (Europe, rev 5)
vindictg	Vindicators (German, rev 1)
vindice4	Vindicators (Europe, rev 4)
vindict4	Vindicators (rev 4)
vindice3	Vindicators (Europe, rev 3)
vindict2	Vindicators (rev 2)
vindict1	Vindicators (rev 1)
toobin	Toobin' (rev 3)
toobine	Toobin' (Europe, rev 3)
toobing	Toobin' (German, rev 3)
toobin2	Toobin' (rev 2)
toobin2e	Toobin' (Europe, rev 2)
toobin1	Toobin' (rev 1)
cyberbal	Cyberball (rev 4)
cyberba2	Cyberball (rev 2)
cyberbap	Cyberball (prototype)
atetcktl	Tetris (Cocktail set 1)
atetckt2	Tetris (Cocktail set 2)
atetris	Tetris (set 1)
atetrisa	Tetris (set 2)
atetrisb	Tetris (bootleg)
eprom	Escape from the Planet of the Robot Monsters (set 1)
eprom2	Escape from the Planet of the Robot Monsters (set 2)
skullxbo	Skull & Crossbones (rev 5)
skullxb4	Skull & Crossbones (rev 4)
skullxb3	Skull & Crossbones (rev 3)
skullxb2	Skull & Crossbones (rev 2)
skullxb1	Skull & Crossbones (rev 1)
cyberbt	Tournament Cyberball 2072 (rev 2)
cyberbt1	Tournament Cyberball 2072 (rev 1)
badlands	Bad Lands
klax	Klax (set 1)
klax2	Klax (set 2)
klax3	Klax (set 3)
klaxj	Klax (Japan)
klaxd	Klax (Germany)
klaxp1	Klax (prototype set 1)
klaxp2	Klax (prototype set 2)
thunderj	ThunderJaws
cyberb2p	Cyberball 2072 (2 player, rev 4)
cyberb23	Cyberball 2072 (2 player, rev 3)
cyberb22	Cyberball 2072 (2 player, rev 2)
cyberb21	Cyberball 2072 (2 player, rev 1)
hydra	Hydra
hydrap	Hydra (prototype 5/14/90)
hydrap2	Hydra (prototype 5/25/90)
pitfight	Pit Fighter (rev 4)
pitfigh3	Pit Fighter (rev 3)
pitfighj	Pit Fighter (Japan, 2 players)
pitfighb	Pit Fighter (bootleg)
rampart	Rampart (Trackball)
ramprt2p	Rampart (Joystick)
rampartj	Rampart (Japan, Joystick)
shuuz	Shuuz (version 8.0)
shuuz2	Shuuz (version 7.1)
batman	Batman
roadriot	Road Riot 4WD
offtwall	Off the Wall (2/3-player upright)
offtwalc	Off the Wall (2-player cocktail)
guardian	Guardians of the Hood
relief	Relief Pitcher (set 1)
relief2	Relief Pitcher (set 2)
arcadecl	Arcade Classics (prototype)
sparkz	Sparkz (prototype)
motofren	Moto Frenzy
spclords	Space Lords
spclorda	Space Lords (alternate)
rrreveng	Road Riot's Revenge (prototype)
rrrevenp	Road Riot's Revenge (prototype alt)
beathead	BeatHead (prototype)
tmek	T-MEK
tmekprot	T-MEK (prototype)
primrage	Primal Rage (version 2.3)
primraga	Primal Rage (version 2.0)
area51	Area 51
area51mx	Area 51 / Maximum Force Duo v2.0
a51mxr3k	Area 51 / Maximum Force Duo (R3000)
maxforce	Maximum Force v1.05
maxf_102	Maximum Force v1.02
vcircle	Vicious Circle (prototype)
sasuke	Sasuke vs. Commander
satansat	Satan of Saturn
zarzon	Zarzon
vanguard	Vanguard (SNK)
vangrdce	Vanguard (Centuri)
fantasy	Fantasy (US)
fantasyj	Fantasy (Japan)
pballoon	Pioneer Balloon
nibbler	Nibbler (set 1)
nibblera	Nibbler (set 2)
lasso	Lasso
chameleo	Chameleon
wwjgtin	Wai Wai Jockey Gate-In!
pinbo	Pinbo
pinbos	Pinbo (Strike)
joyfulr	Joyful Road (Japan)
mnchmobl	Munch Mobile (US)
marvins	Marvin's Maze
madcrash	Mad Crasher
vangrd2	Vanguard II
jcross	Jumping Cross
mainsnk	Main Event (1984)
sgladiat	Gladiator 1984
hal21	HAL21
hal21j	HAL21 (Japan)
aso	ASO - Armored Scrum Object
tnk3	T.N.K. III (US)
tnk3j	T.A.N.K. (Japan)
athena	Athena
fitegolf	Fighting Golf (World?)
fitegol2	Fighting Golf (US)
countryc	Country Club
ikari	Ikari Warriors (US)
ikarijp	Ikari (Japan)
ikarijpb	Ikari (Japan bootleg)
victroad	Victory Road
dogosoke	Dogou Souken
gwar	Guerrilla War (US)
gwarj	Guevara (Japan)
gwara	Guerrilla War (Version 1)
gwarb	Guerrilla War (bootleg)
bermudat	Bermuda Triangle (Japan)
bermudao	Bermuda Triangle (Japan old version)
bermudaa	Bermuda Triangle (US older version)
worldwar	World Wars (World)
psychos	Psycho Soldier (US)
psychosj	Psycho Soldier (Japan)
chopper	Chopper I (US set 1)
choppera	Chopper I (US set 2)
chopperb	Chopper I (US set 3)
legofair	Koukuu Kihei Monogatari - The Legend of Air Cavalry (Japan)
ftsoccer	Fighting Soccer
tdfever	TouchDown Fever
tdfeverj	TouchDown Fever (Japan)
tdfever2	TouchDown Fever 2
ikari3	Ikari III - The Rescue
pow	P.O.W. - Prisoners of War (US)
powj	Datsugoku - Prisoners of War (Japan)
searchar	SAR - Search And Rescue (World)
sercharu	SAR - Search And Rescue (US)
streetsm	Street Smart (US version 2)
streets1	Street Smart (US version 1)
streetsw	Street Smart (World version 1)
streetsj	Street Smart (Japan version 1)
prehisle	Prehistoric Isle in 1930 (World)
prehislu	Prehistoric Isle in 1930 (US)
gensitou	Genshi-Tou 1930's
mechatt	Mechanized Attack (World)
bbusters	Beast Busters (World ?)
shougi	Shougi
shougi2	Shougi 2
champbas	Champion Baseball
champbbj	Champion Baseball (Japan set 1)
champbja	Champion Baseball (Japan set 2)
champbb2	Champion Baseball II
exctsccr	Exciting Soccer
exctscca	Exciting Soccer (alternate music)
exctsccb	Exciting Soccer (bootleg)
exctscc2	Exciting Soccer II
equites	Equites
equitess	Equites (Sega)
bullfgtr	Bull Fighter
kouyakyu	The Koukouyakyuh
splndrbt	Splendor Blast
hvoltage	High Voltage
sstingry	Super Stingray
kyros	Kyros
kyrosj	Kyros No Yakata (Japan)
paddlema	Paddle Mania
timesold	Time Soldiers (US Rev 3)
timesol1	Time Soldiers (US Rev 1)
btlfield	Battle Field (Japan)
skysoldr	Sky Soldiers (US)
goldmedl	Gold Medalist
goldmedb	Gold Medalist (bootleg)
skyadvnt	Sky Adventure (World)
skyadvnu	Sky Adventure (US)
skyadvnj	Sky Adventure (Japan)
gangwars	Gang Wars (US)
gangwarb	Gang Wars (bootleg)
sbasebal	Super Champion Baseball (US)
tnexspce	The Next Space
scregg	Scrambled Egg
eggs	Eggs
dommy	Dommy
bigprowr	The Big Pro Wrestling!
tagteam	Tag Team Wrestling
ssozumo	Syusse Oozumou (Japan)
mystston	Mysterious Stones - Dr. John's Adventure
myststno	Mysterious Stones - Dr. Kick in Adventure
dogfgt	Acrobatic Dog-Fight
dogfgtj	Dog-Fight (Japan)
bogeyman	Bogey Manor
matmania	Mat Mania
excthour	Exciting Hour
maniach	Mania Challenge (set 1)
maniach2	Mania Challenge (set 2)
renegade	Renegade (US)
kuniokun	Nekketsu Kouha Kunio-kun (Japan)
kuniokub	Nekketsu Kouha Kunio-kun (Japan bootleg)
xsleena	Xain'd Sleena
xsleenab	Xain'd Sleena (bootleg)
solarwar	Solar-Warrior
battlane	Battle Lane! Vol. 5 (set 1)
battlan2	Battle Lane! Vol. 5 (set 2)
battlan3	Battle Lane! Vol. 5 (set 3)
ddragon	Double Dragon (Japan)
ddragonu	Double Dragon (US)
ddragonw	Double Dragon (World)
ddragonb	Double Dragon (bootleg)
spdodgeb	Super Dodge Ball (US)
nkdodgeb	Nekketsu Koukou Dodgeball Bu (Japan bootleg)
chinagat	China Gate (US)
saiyugou	Sai Yu Gou Ma Roku (Japan)
saiyugb1	Sai Yu Gou Ma Roku (Japan bootleg 1)
saiyugb2	Sai Yu Gou Ma Roku (Japan bootleg 2)
wwfsstar	WWF Superstars (US)
vball	U.S. Championship V'ball (set 1)
vball2pj	U.S. Championship V'ball (Japan)
ddragon2	Double Dragon II - The Revenge (World)
ddragn2u	Double Dragon II - The Revenge (US)
toffy	Toffy
stoffy	Super Toffy
ddungeon	Dangerous Dungeons
darktowr	Dark Tower
tstrike	Thunder Strike
ctribe	The Combatribes (US)
ctribeb	The Combatribes (bootleg)
blockout	Block Out (set 1)
blckout2	Block Out (set 2)
blckoutj	Block Out (Japan)
ddragon3	Double Dragon 3 - The Rosetta Stone (US)
ddrago3b	Double Dragon 3 - The Rosetta Stone (bootleg)
wwfwfest	WWF WrestleFest (US)
wwfwfsta	WWF WrestleFest (US Tecmo)
wwfwfstj	WWF WrestleFest (Japan)
shadfrce	Shadow Force (US Version 2)
berzerk	Berzerk (set 1)
berzerk1	Berzerk (set 2)
frenzy	Frenzy
mazerbla	Mazer Blazer
greatgun	Great Guns
supdrapo	Super Draw Poker
toratora	Tora Tora
megatack	MegaTack
killcom	Killer Comet
challeng	Challenger
kaos	Kaos
sia2650	Super Invader Attack
tinv2650	The Invaders
dodgem	Dodgem
monymony	Money Money
jackrabt	Jack Rabbit (set 1)
jackrab2	Jack Rabbit (set 2)
jackrabs	Jack Rabbit (special)
mouser	Mouser
mouserc	Mouser (Cosmos)
nova2001	Nova 2001 (Japan)
nov2001u	Nova 2001 (US)
ninjakun	Ninjakun Majou no Bouken
raiders5	Raiders5
raidrs5t	Raiders5 (Japan)
pkunwar	Penguin-Kun Wars (US)
pkunwarj	Penguin-Kun Wars (Japan)
xxmissio	XX Mission
ninjakd2	Ninja-Kid II (set 1)
ninjak2a	Ninja-Kid II (set 2)
ninjak2b	Ninja-Kid II (set 3)
rdaction	Rad Action
mnight	Mutant Night
arkarea	Ark Area
robokid	Atomic Robo-kid
robokidj	Atomic Robo-kid (Japan)
omegaf	Omega Fighter
omegafs	Omega Fighter Special
urashima	Urashima Mahjong
tharrier	Task Force Harrier
tharierj	Task Force Harrier (Japan)
mustang	US AAF Mustang (Japan)
mustangs	US AAF Mustang (Seoul Trading)
mustangb	US AAF Mustang (bootleg)
bioship	Bio-ship Paladin
vandyke	Vandyke (Japan)
vandyjal	Vandyke (Jaleco)
blkheart	Black Heart
blkhearj	Black Heart (Japan)
acrobatm	Acrobat Mission
strahl	Koutetsu Yousai Strahl (Japan set 1)
strahla	Koutetsu Yousai Strahl (Japan set 2)
bjtwin	Bombjack Twin
tdragon2	Thunder Dragon 2
bigbang	Big Bang
tdragon	Thunder Dragon
tdragonb	Thunder Dragon (Bootleg)
hachamf	Hacha Mecha Fighter
macross	Super Spacefortress Macross / Chou-Jikuu Yousai Macross
gunnail	GunNail
macross2	Super Spacefortress Macross II / Chou-Jikuu Yousai Macross II
sabotenb	Saboten Bombers
nouryoku	Nouryoku Koujou Iinkai
manybloc	Many Block
ssmissin	S.S. Mission
raphero	Rapid Hero (Japan?)
daireika	Mahjong Daireikai
mjzoomin	Mahjong Channel Zoom In
kakumei	Mahjong Kakumei
kakumei2	Mahjong Kakumei 2 - Princess League
quizpani	Quiz Panicuru Fantasy
macrossp	Macross Plus
quizmoon	Quiz Bisyoujo Senshi Sailor Moon - Chiryoku Tairyoku Toki no Un
gakupara	Quiz Gakuen Paradise (Japan)
quizdna	Quiz DNA no Hanran (Japan)
gekiretu	Quiz Gekiretsu Scramble (Japan)
narc	Narc (rev 7.00)
narc3	Narc (rev 3.20)
trog	Trog (rev LA4 03/11/91)
trog3	Trog (rev LA3 02/14/91)
trogpa6	Trog (rev PA6-PAC 09/09/90)
trogp	Trog (prototype, rev 4.00 07/27/90)
smashtv	Smash T.V. (rev 8.00)
smashtv6	Smash T.V. (rev 6.00)
smashtv5	Smash T.V. (rev 5.00)
smashtv4	Smash T.V. (rev 4.00)
hiimpact	High Impact Football (rev LA3 12/27/90)
shimpact	Super High Impact (rev LA1 09/30/91)
shimpacp	Super High Impact (prototype, rev 5.0 09/15/91)
strkforc	Strike Force (rev 1 02/25/91)
mk	Mortal Kombat (rev 5.0 T-Unit 03/19/93)
mkr4	Mortal Kombat (rev 4.0 T-Unit 02/11/93)
mkprot9	Mortal Kombat (prototype, rev 9.0 07/28/92)
mkla1	Mortal Kombat (rev 1.0 08/08/92)
mkla2	Mortal Kombat (rev 2.0 08/18/92)
mkla3	Mortal Kombat (rev 3.0 08/31/92)
mkla4	Mortal Kombat (rev 4.0 09/28/92)
term2	Terminator 2 - Judgment Day (rev LA3 03/27/92)
term2la2	Terminator 2 - Judgment Day (rev LA2 12/09/91)
term2la1	Terminator 2 - Judgment Day (rev LA1 11/01/91)
totcarn	Total Carnage (rev LA1 03/10/92)
totcarnp	Total Carnage (prototype, rev 1.0 01/25/92)
mk2	Mortal Kombat II (rev L3.1)
mk2r32	Mortal Kombat II (rev L3.2 (European))
mk2r21	Mortal Kombat II (rev L2.1)
mk2r14	Mortal Kombat II (rev L1.4)
mk2r42	Mortal Kombat II (rev L4.2, hack)
mk2r91	Mortal Kombat II (rev L9.1, hack)
mk2chal	Mortal Kombat II Challenger (hack)
jdreddp	Judge Dredd (rev LA1, prototype)
nbajam	NBA Jam (rev 3.01 04/07/93)
nbajamr2	NBA Jam (rev 2.00 02/10/93)
nbajamte	NBA Jam TE (rev 4.0 03/23/94)
nbajamt1	NBA Jam TE (rev 1.0 01/17/94)
nbajamt2	NBA Jam TE (rev 2.0 01/28/94)
nbajamt3	NBA Jam TE (rev 3.0 03/04/94)
revx	Revolution X (Rev. 1.0 6/16/94)
mk3	Mortal Kombat 3 (rev 2.1)
mk3r20	Mortal Kombat 3 (rev 2.0)
mk3r10	Mortal Kombat 3 (rev 1.0)
umk3	Ultimate Mortal Kombat 3 (rev 1.2)
umk3r11	Ultimate Mortal Kombat 3 (rev 1.1)
wwfmania	WWF: Wrestlemania (rev 1.30 08/10/95)
openice	2 On 2 Open Ice Challenge (rev 1.21)
nbahangt	NBA Hangtime (rev L1.1 04/16/96)
nbamaxht	NBA Maximum Hangtime (rev 1.0 11/8/96)
rmpgwt	Rampage: World Tour (rev 1.3)
rmpgwt11	Rampage: World Tour (rev 1.1)
crusnusa	Cruis'n USA (rev L4.1)
crusnu40	Cruis'n USA (rev L4.0)
crusnu21	Cruis'n USA (rev L2.1)
crusnwld	Cruis'n World (rev L2.3)
crusnw20	Cruis'n World (rev L2.0)
crusnw13	Cruis'n World (rev L1.3)
offroadc	Off Road Challenge
wargods	War Gods
wg3dh	Wayne Gretzky's 3D Hockey
mace	Mace: The Dark Age
sfrush	San Francisco Rush
calspeed	California Speed
carnevil	CarnEvil
biofreak	BioFreaks (prototype)
blitz	NFL Blitz
blitz99	NFL Blitz '99
blitz2k	NFL Blitz 2000
embargo	Embargo
tripool	Tri-Pool (Casino Tech)
tripoola	Tri-Pool (Costal Games)
jack	Jack the Giantkiller (set 1)
jack2	Jack the Giantkiller (set 2)
jack3	Jack the Giantkiller (set 3)
treahunt	Treasure Hunt (Japan?)
zzyzzyxx	Zzyzzyxx (set 1)
zzyzzyx2	Zzyzzyxx (set 2)
brix	Brix
freeze	Freeze
sucasino	Super Casino
spacewar	Space Wars
barrier	Barrier
starcas	Star Castle (version 3)
starcas1	Star Castle (older)
starcasp	Star Castle (prototype)
starcase	Star Castle (Mottoeis)
stellcas	Stellar Castle (Elettronolo)
tailg	Tailgunner
ripoff	Rip Off
armora	Armor Attack
armorap	Armor Attack (prototype)
armorar	Armor Attack (Rock-ola)
wotw	War of the Worlds
warrior	Warrior
starhawk	Star Hawk
solarq	Solar Quest
boxingb	Boxing Bugs
speedfrk	Speed Freak
sundance	Sundance
demon	Demon
cchasm	Cosmic Chasm (set 1)
cchasm1	Cosmic Chasm (set 2)
roundup	Round-Up
fitter	Fitter
thepit	The Pit
dockman	Dock Man
portman	Port Man
funnymou	Funny Mouse
suprmous	Super Mouse
machomou	Macho Mouse
intrepid	Intrepid (set 1)
intrepi2	Intrepid (set 2)
zaryavos	Zarya Vostoka
timelimt	Time Limit
progress	Progress
bagman	Bagman
bagnard	Le Bagnard
bagmans	Bagman (Stern set 1)
bagmans2	Bagman (Stern set 2)
sbagman	Super Bagman
sbagmans	Super Bagman (Stern)
pickin	Pickin'
tankbust	Tank Busters
stinger	Stinger
stinger2	Stinger (prototype?)
scion	Scion
scionc	Scion (Cinematronics)
kungfut	Kung-Fu Taikun
wiz	Wiz
wizt	Wiz (Taito)
kncljoe	Knuckle Joe (set 1)
kncljoea	Knuckle Joe (set 2)
bcrusher	Bone Crusher
empcity	Empire City: 1931 (bootleg?)
empcityj	Empire City: 1931 (Japan)
stfight	Street Fight (Germany)
mustache	Mustache Boy
cshooter	Cross Shooter (not encrypted)
cshootre	Cross Shooter (encrypted)
airraid	Air Raid (encrypted)
deadang	Dead Angle
ghunter	Gang Hunter (Spain)
dynduke	Dynamite Duke
dbldyn	The Double Dynamites
raiden	Raiden
raidena	Raiden (Alternate Hardware)
raidenk	Raiden (Korea)
raident	Raiden (Taiwan)
sdgndmps	SD Gundam Psycho Salamander no Kyoui
dcon	D-Con
sengokmj	Sengoku Mahjong (Japan)
raiden2	Raiden 2
cabal	Cabal (US set 1)
cabal2	Cabal (US set 2)
cabalbl	Cabal (bootleg)
toki	Toki (World set 1)
tokia	Toki (World set 2)
tokij	JuJu Densetsu (Japan)
tokiu	Toki (US)
tokib	Toki (bootleg)
bloodbro	Blood Bros.
weststry	West Story
skysmash	Sky Smasher
legionna	Legionnaire (World)
legionnu	Legionnaire (US)
heatbrl	Heated Barrel (World)
heatbrlo	Heated Barrel (World old version)
heatbrlu	Heated Barrel (US)
godzilla	Godzilla
sdgndmrb	SD Gundam Sangokushi Rainbow Tairiku Senki
cupsoc	Seibu Cup Soccer
cupsoc2	Seibu Cup Soccer (set 2)
olysoc92	Olympic Soccer '92
cupsocbl	Seibu Cup Soccer (bootleg)
goal92	Goal '92
exerion	Exerion
exeriont	Exerion (Taito)
exerionb	Exerion (bootleg)
fcombat	Field Combat
formatz	Formation Z
aeroboto	Aeroboto
citycon	City Connection (set 1)
citycona	City Connection (set 2)
cruisin	Cruisin
momoko	Momoko 120%
argus	Argus
valtric	Valtric
butasan	Butasan (Japan)
psychic5	Psychic 5
ginganin	Ginga NinkyouDen
skyfox	Sky Fox
exerizrb	Exerizer (Japan) (bootleg)
homerun	Moero Pro Yakyuu Homerun
bigrun	Big Run (11th Rallye version)
cischeat	Cisco Heat
f1gpstar	Grand Prix Star
f1gpstr2	F-1 Grand Prix Star II
scudhamm	Scud Hammer
tetrisp2	Tetris Plus 2 (World?)
teplus2j	Tetris Plus 2 (Japan)
rockn	Rock'n Tread (Japan)
lomakai	Legend of Makai (World)
makaiden	Makai Densetsu (Japan)
p47	P-47 - The Phantom Fighter (World)
p47j	P-47 - The Freedom Fighter (Japan)
kickoff	Kick Off (Japan)
tshingen	Takeda Shingen (Japan, Japanese)
tshingna	Shingen Samurai-Fighter (Japan, English)
iganinju	Iga Ninjyutsuden (Japan)
astyanax	The Astyanax
lordofk	The Lord of King (Japan)
hachoo	Hachoo!
jitsupro	Jitsuryoku!! Pro Yakyuu (Japan)
plusalph	Plus Alpha
stdragon	Saint Dragon
rodland	Rod-Land (World)
rodlandj	Rod-Land (Japan)
rodlndjb	Rod-Land (Japan bootleg)
avspirit	Avenging Spirit
phantasm	Phantasm (Japan)
edf	E.D.F. : Earth Defense Force
64street	64th. Street - A Detective Story (World)
64streej	64th. Street - A Detective Story (Japan)
soldamj	Soldam (Japan)
bigstrik	Big Striker
bigstrkb	Big Striker (bootleg)
chimerab	Chimera Beast (prototype)
cybattlr	Cybattler
peekaboo	Peek-a-Boo!
hayaosi1	Hayaoshi Quiz Ouza Ketteisen
bbbxing	Best Bout Boxing
47pie2	Idol Janshi Su-Chi-Pie 2 (v1.1)
47pie2o	Idol Janshi Su-Chi-Pie 2 (v1.0)
desertwr	Desert War / Wangan Sensou
gametngk	The Game Paradise - Master of Shooting! / Game Tengoku - The Game Paradise
tetrisp	Tetris Plus
p47aces	P-47 Aces
akiss	Mahjong Angel Kiss
gratia	Gratia - Second Earth (92047-01 version)
gratiaa	Gratia - Second Earth (91022-10 version)
kirarast	Ryuusei Janshi Kirara Star
tp2m32	Tetris Plus 2 (MegaSystem 32 Version)
f1superb	F1 Super Battle
rabiolep	Rabio Lepus (Japan)
rpunch	Rabbit Punch (US)
svolley	Super Volleyball (Japan)
svolleyk	Super Volleyball (Korea)
svolleyu	Super Volleyball (US)
tail2nos	Tail to Nose - Great Championship
sformula	Super Formula (Japan)
ojankoc	Ojanko Club (Japan)
ojankoy	Ojanko Yakata (Japan)
ojanko2	Ojanko Yakata 2bankan (Japan)
ccasino	Chinese Casino [BET] (Japan)
ojankohs	Ojanko High School (Japan)
nekkyoku	Rettou Juudan Nekkyoku Janshi - Higashi Nippon Hen (Japan)
idolmj	Idol-Mahjong Housoukyoku (Japan)
mjnatsu	Mahjong Natsu Monogatari (Japan)
natsuiro	Natsuiro Mahjong (Japan)
mfunclub	Mahjong Fun Club - Idol Saizensen (Japan)
daiyogen	Mahjong Daiyogen (Japan)
nmsengen	Nekketsu Mahjong Sengen! AFTER 5 (Japan)
fromance	Idol-Mahjong Final Romance (Japan)
pipedrm	Pipe Dream (US)
pipedrmj	Pipe Dream (Japan)
hatris	Hatris (Japan)
spinlbrk	Spinal Breakers (World)
spinlbru	Spinal Breakers (US)
spinlbrj	Spinal Breakers (Japan)
pspikes	Power Spikes (World)
pspikesk	Power Spikes (Korea)
svolly91	Super Volley '91 (Japan)
karatblz	Karate Blazers (World?)
karatblu	Karate Blazers (US)
turbofrc	Turbo Force
aerofgt	Aero Fighters
aerofgtb	Aero Fighters (Turbo Force hardware set 1)
aerofgtc	Aero Fighters (Turbo Force hardware set 2)
sonicwi	Sonic Wings (Japan)
welltris	Welltris (Japan, 2 players)
quiz18k	Miyasu Nonki no Quiz 18-Kin
f1gp	F-1 Grand Prix
f1gp2	F-1 Grand Prix Part II
crshrace	Lethal Crash Race (set 1)
crshrac2	Lethal Crash Race (set 2)
taotaido	Tao Taido (set 1)
taotaida	Tao Taido (set 2)
gstriker	Grand Striker
vgoalsoc	V Goal Soccer
vgoalsca	V Goal Soccer (alt)
worldc94	World Cup '94
suprslam	Super Slams
fromanc2	Taisen Idol-Mahjong Final Romance 2 (Japan)
fromancr	Taisen Mahjong FinalRomance R (Japan)
fromanc4	Taisen Mahjong FinalRomance 4 (Japan)
inufuku	Quiz & Variety Sukusuku Inufuku (Japan)
samuraia	Samurai Aces (World)
sngkace	Sengoku Ace (Japan)
gunbird	Gunbird (World)
gunbirdk	Gunbird (Korea)
gunbirdj	Gunbird (Japan)
btlkroad	Battle K-Road
s1945	Strikers 1945
s1945j	Strikers 1945 (Japan)
s1945jn	Strikers 1945 (Japan, unprotected)
tengai	Tengai / Sengoku Blade: Sengoku Ace Episode II
s1945ii	Strikers 1945 II
soldivid	Sol Divide - The Sword Of Darkness
sbomberb	Space Bomber (ver. B)
daraku	Daraku Tenshi - The Fallen Angels
gunbird2	Gunbird 2
s1945iii	Strikers 1945 III (World) / Strikers 1999 (Japan)
dragnblz	Dragon Blaze
hotgmck	Taisen Hot Gimmick (Japan)
hgkairak	Taisen Hot Gimmick Kairakuten (Japan)
hotgmck3	Taisen Hot Gimmick 3 Digital Surfing (Japan)
loderndf	Lode Runner - The Dig Fight (ver. B) (Japan)
loderdfa	Lode Runner - The Dig Fight (ver. A) (Japan)
hotdebut	Quiz de Idol! Hot Debut (Japan)
marineb	Marine Boy
changes	Changes
looper	Looper
springer	Springer
hoccer	Hoccer (set 1)
hoccer2	Hoccer (set 2)
bcruzm12	Battle Cruiser M-12
hopprobo	Hopper Robo
wanted	Wanted
funkybee	Funky Bee
skylancr	Sky Lancer
zodiack	Zodiack
dogfight	Dog Fight (Thunderbolt)
moguchan	Moguchan
percuss	The Percussor
bounty	The Bounty
espial	Espial (US?)
espiale	Espial (Europe)
netwars	Net Wars
vastar	Vastar (set 1)
vastar2	Vastar (set 2)
xorworld	Xor World (prototype)
bigkarnk	Big Karnak
splash	Splash! (Ver. 1.2 World)
wrally	World Rally (set 1)
wrallya	World Rally (set 2)
glass	Glass
targeth	Target Hits
thoop2	TH Strikes Back
aligator	Alligator Hunt
aligatun	Alligator Hunt (unprotected)
biomtoy	Biomechanical Toy (unprotected)
touchgo	Touch & Go
wrally2	World Rally 2: Twin Racing
maniacsp	Maniac Square (prototype)
maniacsq	Maniac Square (unprotected)
snowboar	Snow Board Championship (set 1)
snowbalt	Snow Board Championship (set 2)
bang	Bang!
bangj	Gun Gabacho (Japan)
airbustr	Air Buster
airbustj	Air Buster (Japan)
djboy	DJ Boy
galpanic	Gals Panic (set 1)
galpanib	Gals Panic (set 2)
galpani2	Gals Panic II (Japan?)
jchan	Jackie Chan - Kung Fu Master
berlwall	The Berlin Wall (set 1)
berlwalt	The Berlin Wall (set 2)
mgcrystl	Magical Crystals (World)
mgcrystj	Magical Crystals (Japan)
blazeon	Blaze On (Japan)
sandscrp	Sand Scorpion
bakubrkr	Bakuretsu Breaker
shogwarr	Shogun Warriors
fjbuster	Fujiyama Buster (Japan)
brapboys	B.Rap Boys
bloodwar	Blood Warrior
bonkadv	Bonks Adventure
gtmr	Great 1000 Miles Rally
gtmre	Great 1000 Miles Rally (Evolution Model)
gtmrusa	Great 1000 Miles Rally (USA)
gtmr2	Mille Miglia 2: Great 1000 Miles Rally
galpani4	Gals Panic 4 (Japan)
galpanis	Gals Panic S - Extra Edition (Japan)
sengekis	Sengeki Striker (Asia)
sengekij	Sengeki Striker (Japan)
vblokbrk	VS Block Breaker (Asia)
sarukani	Saru-Kani-Hamu-Zou (Japan)
cyvern	Cyvern (Japan)
galpans2	Gals Panic S2 (Japan)
panicstr	Panic Street (Japan)
senknow	Sen-Know (Japan)
gutsn	Guts'n (Japan)
puzzloop	Puzz Loop (Europe)
puzloopj	Puzz Loop (Japan)
puzloopu	Puzz Loop (USA)
jjparads	Jan Jan Paradise
jjparad2	Jan Jan Paradise 2
ryouran	VS Mahjong Otome Ryouran
teljan	Tel Jan
hanaawas	Hana Awase (Flower Matching)
speedatk	Speed Attack!
srmp2	Super Real Mahjong Part 2 (Japan)
srmp3	Super Real Mahjong Part 3 (Japan)
mjyuugi	Mahjong Yuugi (Japan set 1)
mjyuugia	Mahjong Yuugi (Japan set 2)
ponchin	Mahjong Pon Chin Kan (Japan set 1)
ponchina	Mahjong Pon Chin Kan (Japan set 2)
tndrcade	Thundercade / Twin Formation
tndrcadj	Tokusyu Butai U.A.G. (Japan)
twineagl	Twin Eagle - Revenge Joe's Brother
downtown	DownTown
usclssic	U.S. Classic
calibr50	Caliber 50
arbalest	Arbalester
metafox	Meta Fox
drgnunit	Dragon Unit / Castle of Dragon
wits	Wit's (Japan)
thunderl	Thunder & Lightning
rezon	Rezon
stg	Strike Gunner S.T.G
blandia	Blandia
blandiap	Blandia (prototype)
blockcar	Block Carnival / Thunder & Lightning 2
qzkklogy	Quiz Kokology
neobattl	SD Gundam Neo Battling (Japan)
umanclub	Ultraman Club - Tatakae! Ultraman Kyoudai!!
zingzip	Zing Zing Zip
atehate	Athena no Hatena ?
jjsquawk	J. J. Squawkers
kamenrid	Masked Riders Club Battle Race
madshark	Mad Shark
msgundam	Mobile Suit Gundam
msgunda1	Mobile Suit Gundam (Japan)
daioh	Daioh
oisipuzl	Oishii Puzzle Ha Irimasenka
triplfun	Triple Fun
utoukond	Ultra Toukon Densetsu (Japan)
qzkklgy2	Quiz Kokology 2
wrofaero	War of Aero - Project MEIOU
eightfrc	Eight Forces
kiwame	Pro Mahjong Kiwame
krzybowl	Krazy Bowl
extdwnhl	Extreme Downhill (v1.5)
gundhara	Gundhara
sokonuke	Sokonuke Taisen Game (Japan)
zombraid	Zombie Raid (US)
gundamex	Mobile Suit Gundam EX Revue
grdians	Guardians / Denjin Makai II
mj4simai	Wakakusamonogatari Mahjong Yonshimai (Japan)
myangel	Kosodate Quiz My Angel (Japan)
myangel2	Kosodate Quiz My Angel 2 (Japan)
pzlbowl	Puzzle De Bowling (Japan)
penbros	Penguin Brothers (Japan)
srmp4	Super Real Mahjong PIV (Japan)
srmp4o	Super Real Mahjong PIV (Japan, older set)
twineag2	Twin Eagle II - The Rescue Mission
srmp7	Super Real Mahjong P7 (Japan)
survarts	Survival Arts (USA)
eaglshot	Eagle Shot Golf
eaglshta	Eagle Shot Golf (alt)
hypreact	Mahjong Hyper Reaction (Japan)
koikois2	Koi Koi Shimasyo 2 - Super Real Hanafuda (Japan)
meosism	Meosis Magic (Japan)
hypreac2	Mahjong Hyper Reaction 2 (Japan)
sxyreact	Pachinko Sexy Reaction (Japan)
cairblad	Change Air Blade (Japan)
keithlcy	Dramatic Adventure Quiz Keith & Lucy (Japan)
drifto94	Drift Out '94 - The Hard Order (Japan)
janjans1	Lovely Pop Mahjong Jan Jan Shimasyo (Japan)
stmblade	Storm Blade (US)
mslider	Monster Slider (Japan)
ryorioh	Gourmet Battle Quiz Ryohrioh CooKing (Japan)
vasara	Vasara
ultrax	Ultra X Weapons / Ultra Keibitai
jsk	Joryuu Syougi Kyoushitsu (Japan)
powerins	Power Instinct (USA bootleg) (set 1)
powerina	Power Instinct (USA bootleg) (set 2)
ohmygod	Oh My God! (Japan)
naname	Naname de Magic! (Japan)
blmbycar	Blomby Car
blmbycau	Blomby Car (not encrypted)
speakres	Speak & Rescue
stratvox	Stratovox
spacecho	Space Echo
route16	Route 16
route16a	Route 16 (set 2)
route16b	Route 16 (bootleg)
routex	Route X (bootleg)
ttmahjng	Mahjong
fnkyfish	Funky Fish
kangaroo	Kangaroo
kangaroa	Kangaroo (Atari)
kangarob	Kangaroo (bootleg)
arabian	Arabian
arabiana	Arabian (Atari)
markham	Markham
strnskil	Strength & Skill
guiness	The Guiness (Japan)
pettanp	Pettan Pyuu (Japan)
ikki	Ikki (Japan)
shanghai	Shanghai (Japan)
shangha2	Shanghai II (Japan)
shangha3	Shanghai III (Japan)
heberpop	Hebereke no Popoon (Japan)
blocken	Blocken (Japan)
goindol	Goindol (World)
goindolu	Goindol (US)
goindolj	Goindol (Japan)
rranger	Rough Ranger (v2.0)
sranger	Super Ranger (v2.0)
srangerb	Super Ranger (bootleg)
srangerw	Super Ranger (WDK)
sparkman	Spark Man (v 2.0)
hardhead	Hard Head
hardhedb	Hard Head (bootleg)
starfigh	Star Fighter (v1)
hardhea2	Hard Head 2 (v2.0)
brickzn	Brick Zone (v5.0)
brickzn3	Brick Zone (v3.0)
bssoccer	Back Street Soccer
uballoon	Ultra Balloon
gundealr	Gun Dealer (set 1)
gundeala	Gun Dealer (set 2)
gundealt	Gun Dealer (Tecmo)
yamyam	Yam! Yam!?
wiseguy	Wise Guy
lastday	The Last Day (set 1)
lastdaya	The Last Day (set 2)
gulfstrm	Gulf Storm
gulfstr2	Gulf Storm (Media Shoji)
pollux	Pollux (set 1)
polluxa	Pollux (set 2)
bluehawk	Blue Hawk
bluehawn	Blue Hawk (NTC)
sadari	Sadari
gundl94	Gun Dealer '94
primella	Primella
superx	Super-X (NTC)
superxm	Super-X (Mitchell)
rshark	R-Shark
leprechn	Leprechaun
potogold	Pot of Gold
beezer	Beezer (set 1)
beezer1	Beezer (set 2)
pushman	Pushman
bballs	Bouncing Balls
zerozone	Zero Zone
lvgirl94	Las Vegas Girl (Girl '94)
hotpinbl	Hot Pinball
galspnbl	Gals Pinball
fantasia	Fantasia
newfant	New Fantasia
fantsy95	Fantasy '95
missw96	Miss World '96 Nude
fantsia2	Fantasia II
galhustl	Gals Hustler
sslam	Super Slam
bigtwin	Big Twin
wbeachvl	World Beach Volley
sharkatt	Shark Attack
thief	Thief
natodef	NATO Defense
natodefa	NATO Defense (alternate mazes)
mrflea	The Amazing Adventures of Mr. F. Lea
holeland	Hole Land
crzrally	Crazy Rally
speedbal	Speed Ball
sauro	Sauro
trckydoc	Tricky Doc
karatour	The Karate Tournament
ladykill	Lady Killer
moegonta	Moeyo Gonta!! (Japan)
pangpoms	Pang Poms
pangpomm	Pang Poms (Mitchell)
skyalert	Sky Alert
poitto	Poitto!
dharma	Dharma Doujou
lastfort	Last Fortress - Toride
lastfero	Last Fortress - Toride (Erotic)
toride2g	Toride II Adauchi Gaiden
daitorid	Daitoride
dokyusei	Mahjong Doukyuusei
dokyusp	Mahjong Doukyuusei Special
puzzli	Puzzli
3kokushi	Sankokushi (Japan)
pururun	Pururun
balcube	Bal Cube
mouja	Mouja (Japan)
bangball	Bang Bang Ball (v1.05)
gakusai	Mahjong Gakuensai (Japan)
gakusai2	Mahjong Gakuensai 2 (Japan)
blzntrnd	Blazing Tornado
gstrik2	Grand Striker 2 (Japan)
hyprduel	Hyper Duel (World)
hyprdelj	Hyper Duel (Japan)
spcforce	Space Force
spcforc2	Space Force (set 2)
meteor	Meteoroids
looping	Looping (set 1)
loopinga	Looping (set 2)
skybump	Sky Bumper
paradise	Paradise
tgtball	Target Ball
cannball	Cannon Ball
magix	Magix / Rock
magicbub	Magic Bubble
shocking	Shocking
blueprnt	Blue Print (Midway)
blueprnj	Blue Print (Jaleco)
saturn	Saturn
gogomile	Go Go! Mile Smile
gogomilj	Susume! Mile Smile (Japan)
pbancho	Gyakuten!! Puzzle Bancho (Japan)
asurabld	Asura Blade - Sword of Dynasty (Japan)
drgnmst	Dragon Master
burglarx	Burglar X
zeropnt	Zero Point (set 1)
zeropnta	Zero Point (set 2)
zeropnt2	Zero Point 2
silkroad	The Legend of Silkroad
stagger1	Stagger I (Japan)
redhawk	Red Hawk (US)
grdnstrm	Sen Jin - Guardian Storm (Korea)
bubl2000	Bubble 2000
multchmp	Multi Champ (Korea)
hedpanic	Head Panic (Korea?)
royalmah	Royal Mahjong (Japan)
suzume	Watashiha Suzumechan (Japan)
hnayayoi	Hana Yayoi (Japan)
dondenmj	Don Den Mahjong [BET] (Japan)
hnfubuki	Hana Fubuki [BET] (Japan)
mjdiplob	Mahjong Diplomat [BET] (Japan)
untoucha	Untouchable (Japan)
tontonb	Tonton [BET] (Japan)
hanamai	Hana no Mai (Japan)
majs101b	Mahjong Studio 101 [BET] (Japan)
hnkochou	Hana Kochou [BET] (Japan)
mjderngr	Mahjong Derringer (Japan)
hnoridur	Hana Oriduru (Japan)
drgpunch	Dragon Punch (Japan)
mjfriday	Mahjong Friday (Japan)
mjifb	Mahjong If [BET] (Japan)
sprtmtch	Sports Match
maya	Maya
roldfrog	The Return of Lady Frog
roldfrga	The Return of Lady Frog (set 2)
mcnpshnt	Mahjong Campus Hunting (Japan)
7jigen	7jigen no Youseitachi - Mahjong 7 Dimensions (Japan)
mjdialq2	Mahjong Dial Q2 (Japan)
yarunara	Mahjong Yarunara (Japan)
mjangels	Mahjong Angels - Comic Theater Vol.2 (Japan)
quiztvqq	Quiz TV Gassyuukoku Q&Q (Japan)
mmpanic	Monkey Mole Panic (USA)
quizchq	Quiz Channel Question (Ver 1.00) (Japan)
quizchql	Quiz Channel Question (Ver 1.23) (Taiwan?)
quiz365	Quiz 365 (Hong Kong & Taiwan)
rongrong	Rong Rong (Germany)
nettoqc	Nettoh Quiz Champion (Japan)
ddenlovr	Don Den Lover Vol. 1 (Hong Kong)
hanakanz	Hanakanzashi (Japan)
realbrk	Billiard Academy Real Break (Japan)
nyny	New York New York
nynyg	New York New York (Gottlieb)
arcadia	Waga Seishun no Arcadia
r2dtank	R2D Tank
spiders	Spiders (set 1)
spiders2	Spiders (set 2)
iqblock	IQ-Block
grndtour	Grand Tour
cabaret	Cabaret
chindrag	China Dragon / Dragon World
grtwall	The Great Wall
orlegend	Oriental Legend / Xi Yo Gi Shi Re Zuang (ver. 126)
orlegnde	Oriental Legend / Xi Yo Gi Shi Re Zuang (ver. 112)
orlegndc	Oriental Legend / Xi Yo Gi Shi Re Zuang (ver. 112, Chinese Board)
dragwld2	Zhong Guo Long II (ver. 100C, China)
kov	Knights of Valour / Sangoku Senki (ver. 117)
kovplus	Knights of Valour Plus / Sangoku Senki Plus (ver. 119)
kov115	Knights of Valour / Sangoku Senki (ver. 115)
kovsh	Knights of Valour Superheroes / Sangoku Senki Superheroes (ver. 322)
photoy2k	Photo Y2K
hitme	Hit Me
mblkjack	Black Jack (Mirco)
barricad	Barricade
brickyrd	Brickyard
starcrus	Star Cruiser
battlex	Battle Cross
carjmbre	Car Jamboree
popper	Popper
speedspn	Speed Spin
kickgoal	Kick Goal
usg32	Super Duper Casino (California V3.2)
usg82	Super Ten V8.2
usg83	Super Ten V8.3
usg83x	Super Ten V8.3X
usg185	Games V18.7C
usg252	Games V25.4X
mermaid	Mermaid
rougien	Rougien
drmicro	Dr. Micro
appoooh	Appoooh
bankp	Bank Panic
mjkjidai	Mahjong Kyou Jidai (Japan)
mayumi	Kikiippatsu Mayumi-chan (Japan)
btoads	Battle Toads
kinst	Killer Instinct (v1.0)
kinst2	Killer Instinct 2 (v2.1)
gigasb	Gigas (bootleg)
gigasm2b	Gigas Mark II (bootleg)
oigas	Oigas (bootleg)
pbillrd	Perfect Billiard
pbillrds	Perfect Billiard (Sega)
freekick	Free Kick
freekckb	Free Kick (bootleg)
countrun	Counter Run
countrnb	Counter Run (bootleg)
rmhaihai	Real Mahjong Haihai (Japan)
rmhaihib	Real Mahjong Haihai [BET] (Japan)
rmhaijin	Real Mahjong Haihai Jinji Idou Hen (Japan)
rmhaisei	Real Mahjong Haihai Seichouhen (Japan)
themj	The Mah-jong (Japan)
hanaroku	Hanaroku
yumefuda	(Medal) Yumefuda
hourouki	Mahjong Hourouki Part 1 - Seisyun Hen (Japan)
mhgaiden	Mahjong Hourouki Gaiden (Japan)
mjhokite	Mahjong Hourouki Okite (Japan)
mjclinic	Mahjong Clinic (Japan)
mrokumei	Mahjong Rokumeikan (Japan)
reikaids	Reikai Doushi (Japan)
mjkojink	Mahjong Kojinkyouju (Private Teacher) (Japan)
vitaminc	Mahjong Vitamin C (Japan)
mjyougo	Mahjong-yougo no Kisotairyoku (Japan)
lemnangl	Mahjong Lemon Angel (Japan)
mjkinjas	Mahjong Kinjirareta Asobi (Japan)
battlcry	Battlecry
jogakuen	Mahjong Jogakuen (Japan)
mjikaga	Mahjong Ikaga Desu ka (Japan)
ultennis	Ultimate Tennis
cheesech	Cheese Chase
stonebal	Stone Ball (4 Players)
stoneba2	Stone Ball (2 Players)
dynamski	Dynamic Ski
chinhero	Chinese Hero
chinher2	Chinese Hero (older)
shangkid	Shanghai Kid
hiryuken	Hokuha Syourin Hiryu no Ken
astinvad	Astro Invader
kamikaze	Kamikaze
spcking2	Space King 2
spaceint	Space Intruder
spacefb	Space Firebird (Nintendo)
spacefbg	Space Firebird (Gremlin)
spacefbb	Space Firebird (bootleg)
spacebrd	Space Bird (bootleg)
spacedem	Space Demon
omegrace	Omega Race
deltrace	Delta Race
dday	D-Day
ddayc	D-Day (Centuri)
hexa	Hexa
stactics	Space Tactics
exterm	Exterminator
kingofb	King of Boxer (English)
ringking	Ring King (US set 1)
ringkin2	Ring King (US set 2)
ringkin3	Ring King (US set 3)
ambush	Ambush
ambusht	Ambush (Tecfri)
homo	Homo
dlair	Dragon's Lair
aztarac	Aztarac
mole	Mole Attack
thehand	The Hand
gotya	Got-Ya (12/24/1981, prototype?)
mrjong	Mr. Jong (Japan)
crazyblk	Crazy Blocks
blkbustr	BlockBuster
polyplay	Poly-Play
amspdwy	American Speedway (set 1)
amspdwya	American Speedway (set 2)
othldrby	Othello Derby (Japan)
mosaic	Mosaic
mosaica	Mosaic (Fuuki)
gfire2	Golden Fire II
spdbuggy	Speed Buggy
sprcros2	Super Cross 2 (Japan)
mugsmash	Mug Smashers
stlforce	Steel Force
fantland	Fantasy Land
galaxygn	Galaxy Gunners
gcpinbal	Grand Cross
aquarium	Aquarium (Japan)
policetr	Police Trainer (Rev 1.3)
policeto	Police Trainer (Rev 1.1)
plctr13b	Police Trainer (Rev 1.3B)
sshooter	Sharpshooter (Rev 1.7)
pass	Pass
news	News
taxidrvr	Taxi Driver
xyonix	Xyonix
findout	Find Out
dribling	Dribbling
driblino	Dribbling (Olympia)
ace	Ace
clayshoo	Clay Shoot
pirates	Pirates
genix	Genix Family
fitfight	Fit of Fighting
histryma	The History of Martial Arts
bbprot	Untitled Fighter 'BB' (prototype)
flower	Flower
diverboy	Diver Boy
beaminv	Beam Invader
mcatadv	Magical Cat Adventure
mcatadvj	Magical Cat Adventure (Japan)
nost	Nostradamus
nostj	Nostradamus (Japan)
nostk	Nostradamus (Korea)
4enraya	4 En Raya
oneshot	One Shot One Kill
maddonna	Mad Donna (set 1)
maddonnb	Mad Donna (set 2)
tugboat	Tugboat
gotcha	Got-cha
amerdart	AmeriDarts
coolpool	Cool Pool
9ballsht	9-Ball Shootout (set 1)
9ballsh2	9-Ball Shootout (set 2)
9ballsh3	9-Ball Shootout (set 3)
gumbo	Gumbo
trivquiz	Triv Quiz
statriv2	(Status) Triv Two
supertr2	Super Triv II
tickee	Tickee Tickats
crgolf	Crowns Golf (set 1)
crgolfa	Crowns Golf (set 2)
crgolfb	Champion Golf (bootleg Set 1)
crgolfc	Champion Golf
truco	Truco-Tron
thedeep	The Deep (Japan)
rundeep	Run Deep
wallc	Wall Crash
skyarmy	Sky Army
lethalj	Lethal Justice
eggventr	Egg Venture
eggvntdx	Egg Venture Deluxe
rotaryf	Rotary Fighter
sbugger	Space Bugger
portrait	Portraits
enigma2	Enigma 2
enigma2a	Enigma 2 (Space Invaders Hardware)
ltcasino	Little Casino
ltcasin2	Little Casino 2
vamphalf	Vamp 1/2
hidnctch	Hidden Catch
landbrk	Land Breaker
racoon	Racoon World
xfiles	X-Files
strvmstr	Super Trivia Master
dorachan	Dorachan
ladyfrog	Lady Frog
rabbit	Rabbit
tmmjprd	Tokimeki Mahjong Paradise - Dear My Love
malzak	Malzak
supertnk	Super Tank
crospang	Cross Pang
funybubl	Funny Bubble
nam1975	NAM-1975
bstars	Baseball Stars Professional
tpgolf	Top Player's Golf
mahretsu	Mahjong Kyoretsuden
maglord	Magician Lord (set 1)
maglordh	Magician Lord (set 2)
ridhero	Riding Hero (set 1)
ridheroh	Riding Hero (set 2)
alpham2	Alpha Mission II / ASO II - Last Guardian
ncombat	Ninja Combat
cyberlip	Cyber-Lip
superspy	The Super Spy
mutnat	Mutation Nation
kotm	King of the Monsters (set 1)
kotmh	King of the Monsters (set 2)
sengoku	Sengoku / Sengoku Denshou (set 1)
sengokh	Sengoku / Sengoku Denshou (set 2)
burningf	Burning Fight (set 1)
burningh	Burning Fight (set 2)
lbowling	League Bowling
gpilots	Ghost Pilots
joyjoy	Puzzled / Joy Joy Kid
bjourney	Blue's Journey / Raguy
quizdais	Quiz Daisousa Sen - The Last Count Down
lresort	Last Resort
eightman	Eight Man
minasan	Minnasanno Okagesamadesu
legendos	Legend of Success Joe / Ashitano Joe Densetsu
2020bb	2020 Super Baseball (set 1)
2020bbh	2020 Super Baseball (set 2)
socbrawl	Soccer Brawl
roboarmy	Robo Army
fatfury1	Fatal Fury - King of Fighters / Garou Densetsu - shukumei no tatakai
fbfrenzy	Football Frenzy
bakatono	Bakatonosama Mahjong Manyuki
crsword	Crossed Swords
trally	Thrash Rally
kotm2	King of the Monsters 2 - The Next Thing
sengoku2	Sengoku 2 / Sengoku Denshou 2
bstars2	Baseball Stars 2
quizdai2	Quiz Meitantei Neo & Geo - Quiz Daisousa Sen part 2
3countb	3 Count Bout / Fire Suplex
aof	Art of Fighting / Ryuuko no Ken
samsho	Samurai Shodown / Samurai Spirits
tophuntr	Top Hunter - Roddy & Cathy
fatfury2	Fatal Fury 2 / Garou Densetsu 2 - arata-naru tatakai
janshin	Jyanshin Densetsu - Quest of Jongmaster
androdun	Andro Dunos
ncommand	Ninja Commando
viewpoin	Viewpoint
ssideki	Super Sidekicks / Tokuten Ou
wh1	World Heroes (set 1)
wh1h	World Heroes (set 2)
kof94	The King of Fighters '94
aof2	Art of Fighting 2 / Ryuuko no Ken 2
wh2	World Heroes 2
fatfursp	Fatal Fury Special / Garou Densetsu Special (set 1)
fatfursa	Fatal Fury Special / Garou Densetsu Special (set 2)
savagere	Savage Reign / Fu'un Mokushiroku - kakutou sousei
fightfev	Fight Fever (set 1)
fightfva	Fight Fever (set 2)
ssideki2	Super Sidekicks 2 - The World Championship / Tokuten Ou 2 - real fight football
spinmast	Spin Master / Miracle Adventure
samsho2	Samurai Shodown II / Shin Samurai Spirits - Haohmaru jigokuhen
wh2j	World Heroes 2 Jet
wjammers	Windjammers / Flying Power Disc
karnovr	Karnov's Revenge / Fighter's History Dynamite
gururin	Gururin
pspikes2	Power Spikes II
fatfury3	Fatal Fury 3 - Road to the Final Victory / Garou Densetsu 3 - haruka-naru tatakai
panicbom	Panic Bomber
aodk	Aggressors of Dark Kombat / Tsuukai GANGAN Koushinkyoku
sonicwi2	Aero Fighters 2 / Sonic Wings 2
zedblade	Zed Blade / Operation Ragnarok
galaxyfg	Galaxy Fight - Universal Warriors
strhoop	Street Hoop / Street Slam / Dunk Dream
quizkof	Quiz King of Fighters
ssideki3	Super Sidekicks 3 - The Next Glory / Tokuten Ou 3 - eikoue no michi
doubledr	Double Dragon (Neo-Geo)
pbobblen	Puzzle Bobble / Bust-A-Move (Neo-Geo) (set 1)
pbobblna	Puzzle Bobble / Bust-A-Move (Neo-Geo) (set 2)
kof95	The King of Fighters '95 (set 1)
kof95a	The King of Fighters '95 (set 2)
tws96	Tecmo World Soccer '96
samsho3	Samurai Shodown III / Samurai Spirits - Zankurou Musouken
stakwin	Stakes Winner / Stakes Winner - GI kinzen seihae no michi
pulstar	Pulstar
whp	World Heroes Perfect
kabukikl	Far East of Eden - Kabuki Klash / Tengai Makyou - Shin Den
neobombe	Neo Bomberman
gowcaizr	Voltage Fighter - Gowcaizer / Choujin Gakuen Gowcaizer
rbff1	Real Bout Fatal Fury / Real Bout Garou Densetsu
aof3	Art of Fighting 3 - The Path of the Warrior / Art of Fighting - Ryuuko no Ken Gaiden
sonicwi3	Aero Fighters 3 / Sonic Wings 3
turfmast	Neo Turf Masters / Big Tournament Golf
mslug	Metal Slug - Super Vehicle-001
puzzledp	Puzzle De Pon!
mosyougi	Syougi No Tatsujin - Master of Syougi
marukodq	Chibi Marukochan Deluxe Quiz
neomrdo	Neo Mr. Do!
sdodgeb	Super Dodge Ball / Kunio no Nekketsu Toukyuu Densetsu
goalx3	Goal! Goal! Goal!
overtop	Over Top
neodrift	Neo Drift Out - New Technology
kof96	The King of Fighters '96 (set 1)
kof96h	The King of Fighters '96 (set 2)
ssideki4	Ultimate 11 - The SNK Football Championship / Tokuten Ou - Honoo no Libero, The
kizuna	Kizuna Encounter - Super Tag Battle / Fu'un Super Tag Battle
ninjamas	Ninja Master's - haoh-ninpo-cho
ragnagrd	Ragnagard / Shin-Oh-Ken
pgoal	Pleasure Goal / Futsal - 5 on 5 Mini Soccer
magdrop2	Magical Drop II
samsho4	Samurai Shodown IV - Amakusa's Revenge / Samurai Spirits - Amakusa Kourin
rbffspec	Real Bout Fatal Fury Special / Real Bout Garou Densetsu Special
twinspri	Twinkle Star Sprites
wakuwak7	Waku Waku 7
stakwin2	Stakes Winner 2
breakers	Breakers
miexchng	Money Puzzle Exchanger / Money Idol Exchanger
kof97	The King of Fighters '97 (set 1)
kof97a	The King of Fighters '97 (set 2)
magdrop3	Magical Drop III
lastblad	Last Blade / Bakumatsu Roman - Gekka no Kenshi, The (set 1)
lastblda	Last Blade / Bakumatsu Roman - Gekka no Kenshi, The (set 2)
puzzldpr	Puzzle De Pon! R!
irrmaze	The Irritating Maze / Ultra Denryu Iraira Bou
popbounc	Pop 'n Bounce / Gapporin
shocktro	Shock Troopers (set 1)
shocktra	Shock Troopers (set 2)
blazstar	Blazing Star
rbff2	Real Bout Fatal Fury 2 - The Newcomers / Real Bout Garou Densetsu 2 - the newcomers (set 1)
rbff2a	Real Bout Fatal Fury 2 - The Newcomers / Real Bout Garou Densetsu 2 - the newcomers (set 2)
mslug2	Metal Slug 2 - Super Vehicle-001/II
kof98	The King of Fighters '98 - The Slugfest / King of Fighters '98 - dream match never ends
kof98n	The King of Fighters '98 - The Slugfest / King of Fighters '98 - dream match never ends (not encrypted)
lastbld2	Last Blade 2 / Bakumatsu Roman - Dai Ni Maku Gekka no Kenshi, The
neocup98	Neo-Geo Cup '98 - The Road to the Victory
breakrev	Breakers Revenge
shocktr2	Shock Troopers - 2nd Squad
flipshot	Battle Flip Shot
pbobbl2n	Puzzle Bobble 2 / Bust-A-Move Again (Neo-Geo)
ctomaday	Captain Tomaday
mslugx	Metal Slug X - Super Vehicle-001
kof99	The King of Fighters '99 - Millennium Battle (set 1)
kof99a	The King of Fighters '99 - Millennium Battle (set 2)
kof99e	The King of Fighters '99 - Millennium Battle (earlier)
kof99n	The King of Fighters '99 - Millennium Battle (not encrypted)
kof99p	The King of Fighters '99 - Millennium Battle (prototype)
ganryu	Musashi Ganryuuki
garou	Garou - Mark of the Wolves (set 1)
garouo	Garou - Mark of the Wolves (set 2)
garoup	Garou - Mark of the Wolves (prototype)
s1945p	Strikers 1945 Plus
preisle2	Prehistoric Isle 2
mslug3	Metal Slug 3
mslug3n	Metal Slug 3 (not encrypted)
kof2000	The King of Fighters 2000
kof2000n	The King of Fighters 2000 (not encrypted)
bangbead	Bang Bead
nitd	Nightmare in the Dark
neogeo	Neo-Geo
cvs	CVS Bios
decocass	Cassette System
playch10	PlayChoice-10
pgm	PGM (Polygame Master) System BIOS
skns	Super Kaneko Nova System BIOS
stvbios	ST-V Bios
konamigx	System GX
nss	Nintendo Super System: BIOS
megatech	MegaTech: Bios
megaplay	MegaPlay: Bios
cpzn1	ZN1
cpzn2	ZN2
tps	TPS
taitofx1	Taito FX1
acpsx	Acclaim PSX